o: (C) The fifteenth letter of the English alphabet, called o and written in the Latin script.; Alternative form of ο, the fifteenth letter of the Classical and Modern Greek alphabets, called omicron and (astronomy) used as an abbreviation of omicron in star names.(0) The ordinal number fifteenth, derived from this letter of the English alphabet, called o and written in the Latin script.(S) (a) an initial letter ⟨o⟩(n) The name of the Latin-script letter O.; A zero (used in reading out numbers).(pa) alternative form of O (vocative particle)(i) Alternative form of oh(n) Operator; Object, see SVO(aj) Over(p) Alternative form of of
O: (C) The fifteenth letter of the English alphabet, called o and written in the Latin script.(n) Something shaped like the letter O.; A blood type that lacks A or B antigens and may only receive transfusions of similar type O blood, but may donate to all (neglecting Rh factor). Synonym: universal donor.(0) The ordinal number fifteenth, derived from this letter of the English alphabet, called o and written in the Latin script.(pa) The English vocative particle, used for direct address.(n) American Library Association abbreviation of octavo, a book size (20-25 cm).; Someone associated with Leyton Orient Football Club, as a player, coach, supporter etc.; The number of overs bowled.; Orgasm.; Opium.(N) A surname, from Korean.(N) Alternative form of E
oaf: (n) A person, especially a large male, who is clumsy or a simpleton.; An elf's child; a changeling left by fairies or goblins, hence, a deformed or foolish child.
Oahu: (N) The third-largest island of Hawaii, included in the City and County of Honolulu.
oak: (n) A deciduous tree with distinctive deeply lobed leaves, acorns, and notably strong wood, typically of England and northeastern North America, included in genus Quercus.; The wood of the oak.; A rich brown colour, like that of oak wood.; Any tree of the genus Quercus, in family Fagaceae.; Any tree of other genera and species of trees resembling typical oaks of genus Quercus in some ways.; The she-oaks in Allocasuarina and Casuarina, of family Casuarinaceae; Any tree of other genera and species of trees resembling typical oaks of genus Quercus in some ways.; Lagunaria, white oak, in family Malvaceae; Any tree of other genera and species of trees resembling typical oaks of genus Quercus in some ways.; Various species called silky oak, in family Proteaceae; Any tree of other genera and species of trees resembling typical oaks of genus Quercus in some ways.; Toxicodendron, poison oak, in family Anacardiaceae; Any tree of other genera and species of trees resembling typical oaks of genus Quercus in some ways.; Various tanbark oak or stone oak species in family Fagaceae, genera Lithocarpus and Notholithocarpus.; The outer (lockable) door of a set of rooms in a college or similar institution. (Often in the phrase "to sport one's oak").; The flavor of oak.(aj) having a rich brown colour, like that of oak wood.; made of oak wood or timber(v) To expose to oak in order for the oak to impart its flavors.
oaken: (aj) Made from the wood of the oak tree. Also in metaphorical uses, suggesting robustness.
oaks: (n) plural of oak(n) A stakes race in which entry is restricted to 3-year-old fillies.
oakum: (n) A material, consisting of tarred fibres, used to caulk or pack joints in plumbing, masonry, and wooden shipbuilding.; The coarse portion separated from flax or hemp in hackling.
oar: (n) A type of lever used to propel a boat, having a flat blade at one end and a handle at the other, and pivoted in a rowlock atop the gunwale, whereby a rower seated in the boat and pulling the handle can pass the blade through the water by repeated strokes against the water's resistance, thus moving the boat.; An oarsman; a rower.; An oar-like swimming organ of various invertebrates.(v) To row; to travel with, or as if with, oars.
oared: (aj) Having oars.(v) simple past tense and past participle of oar
oars: (n) plural of oar(v) Third-person singular simple present indicative form of oar
oases: (n) plural of oasis
oasis: (n) A spring of fresh water, surrounded by a fertile region of vegetation, in a desert.; A quiet, peaceful place or situation separated from surrounding noise or bustle.
Oasis: (N) A census-designated place in Riverside County, California, United States.; A census-designated place in Elko County, Nevada, United States.
oast: (n) A kiln for drying tobacco, malt and especially hops.
oat: (n) Widely cultivated cereal grass, typically Avena sativa.; Any of the numerous species, varieties, or cultivars of any of several similar grain plants in genus Avena.; The seeds of the oat, a grain, harvested as a food crop.; A simple musical pipe made of oat-straw.; The tiniest amount; a whit or jot.
oaten: (aj) Made of oats
Oates: (N) A surname.; An unincorporated community in Reynolds County, Missouri, United States.
oath: (n) A solemn pledge or promise that invokes a deity, a ruler, or another entity (not necessarily present) to attest the truth of a statement or sincerity of one's desire to fulfill a contract or promise.; A statement or promise which is strengthened (affirmed) by such a pledge.; A light, irreverent or insulting appeal to a deity or other entity.; A curse, a curse word.(v) To pledge.
oaths: (n) plural of oath(v) Third-person singular simple present indicative form of oath
oats: (n) plural of oat(n) A mass of oat plants (genus Avena, especially Avena sativa).; Seeds of an oat plant, especially prepared as food.
ob: (n) a halfpenny(n) an objection; the obese gene
Ob: (N) A river in Russia; the westernmost of the three great Siberian rivers.(S) The set of objects of a category.
obduce: (v) To draw over, as a covering.
obeah: (n) A form of folk magic, medicine or witchcraft originating in Africa and practised in parts of the Caribbean.; A magician or witch doctor of the magic craft.; A spell performed in the practice of the magic craft; an item associated with such a spell.(v) To bewitch using this kind of folk magic.
Oberon: (N) A fictional character in medieval and Renaissance literature, the king of the fairies, appearing for example in William Shakespeare's play A Midsummer Night's Dream.; The outermost major moon of Uranus.; A town in New South Wales, Australia.; A city and town in North Dakota.
obese: (aj) Extremely overweight, especially: weighing more than 20% (for men) or 25% (for women) over their ideal weight determined by height and build; or, having a body mass index over 30 kg/m².
obeser: (adj) plural of obese
obey: (v) To do as ordered by (a person, institution etc), to act according to the bidding of.; To do as one is told.; To be obedient, compliant (to a given law, restriction etc.).
obeyed: (v) simple past tense and past participle of obey
obeys: (v) Third-person singular simple present indicative form of obey
obi: (n) A sash worn with a kimono.; A strip of paper looped around a book or other product.(n) Alternative form of obeah
obied: (v) plural of obi
obiing: (v) plural of obi
obit: (n) Death of a person.; A mass or other service held for the soul of a dead person.; A record of a person's death.(n) An obituary.
object: (n) A thing that has physical existence.; Objective; goal, end or purpose of something.; The noun phrase which is an internal complement of a verb phrase or a prepositional phrase. In a verb phrase with a transitive action verb, it is typically the receiver of the action.; A person or thing toward which an emotion is directed.; An instantiation of a class or structure.; An instance of one of the two kinds of entities that form a category, the other kind being the arrows (also called morphisms).; Sight; show; appearance; aspect.(v) To disagree with or oppose something or someone; (especially in a Court of Law) to raise an objection.; To offer in opposition as a criminal charge or by way of accusation or reproach; to adduce as an objection or adverse reason.; To set before or against; to bring into opposition; to oppose.
oblast: (n) A region or province in Slavic or Slavic-influenced countries.
oblate: (n) A person dedicated to a life of religion or monasticism, especially a member of an order without religious vows or a lay member of a religious community.; A child given up by its parents into the keeping or dedication of a religious order or house.(aj) Flattened or depressed at the poles.(v) To offer as either a gift or an oblation.
oblige: (v) To constrain someone by force or by social, moral or legal means.; To do (someone) a service or favour (hence, originally, creating an obligation).; To be indebted to someone.
oblong: (aj) Having a length and width that are different; not square or circular.; Roughly rectangular or elliptical.(n) Something with an oblong shape.; A rectangle with length and width that are different.; An ellipse with minor and major axes that are different.
oboe: (n) A soprano and melody wind instrument in the modern orchestra and wind ensemble. It is a smaller instrument and generally made of grenadilla wood. It is a member of the double reed family.
obolus: (n) A silver coin minted in Ancient Greece, valued at a sixth of a drachma.; A unit of weight, equal to one-sixth of a drachma.(n) Alternative form of obelus
obs: (n) Observation(s) (blood pressure, temperature, etc).(n) police observation; An observation hut.(n) plural of ob
Obs: (aj) Alternative form of obs (obsolete)
obsess: (v) To be preoccupied with a single topic or emotion.; To dominate the thoughts of someone.; To think or talk obsessively about.
obtain: (v) To get hold of; to gain possession of, to procure; to acquire, in any way.; To secure (that) a specific objective or state of affairs be reached.; To prevail, be victorious; to succeed.; To hold; to keep, possess or occupy.; To exist or be the case; to hold true, be in force.
obtect: (aj) Having the legs and other appendages more or less strongly cemented to the body.
obtest: (v) To implore, beseech, plead, beg.; To call on a witness (often God) to confirm that something is true.
obtund: (v) To reduce the edge or effects of; to mitigate; to dull.
obtuse: (aj) Blunt; not sharp, pointed, or acute in form.; Blunt, or rounded at the extremity.; Blunt; not sharp, pointed, or acute in form.; Larger than one, and smaller than two right angles, or more than 90° and less than 180°.; Blunt; not sharp, pointed, or acute in form.; Obtuse-angled, having an obtuse angle.; Intellectually dull or dim-witted.; Of sound, etc.: deadened, muffled, muted.; Indirect or circuitous.(v) To dull or reduce an emotion or a physical state.
obvert: (v) To turn so as to show another side.; To turn towards the front.; To infer by obversion.(n) The result of obversion.
occult: (v) To cover or hide from view.; To dissimulate, conceal, or obfuscate.(aj) Secret; hidden from general knowledge; undetected.; Related to the occult; pertaining to mysticism, magic, or astrology.; Esoteric.(n) Supernatural affairs.
occupy: (v) To take or use.; To fill.; To take or use.; To possess or use the time or capacity of; to engage the service of.; To take or use.; To fill or hold (an official position or role).; To take or use.; To hold the attention of.; To take or use space.; To fill space.; To take or use space.; To live or reside in.; To take or use space.; To have, or to have taken, possession or control of (a territory).; To take or use space.; To place the theodolite or total station at (a point).; To have sexual intercourse with.; To do business in; to busy oneself with.; To use; to expend; to make use of.
Occupy: (N) Synonym of OWS (“"Occupy Wall Street" protest movement”)
occur: (v) To happen or take place.; To present or offer itself.; To come or be presented to the mind; to suggest itself.; To be present or found.
occurs: (v) Third-person singular simple present indicative form of occur
ocean: (n) One of the large bodies of water separating the continents.; Water belonging to an ocean.; An immense expanse; any vast space or quantity without apparent limits.; A blue colour, like that of the ocean (also called ocean blue).
Ocean: (N) A female given name from English, of modern usage.
oceans: (n) plural of ocean
ocelot: (n) An American feline carnivore (Leopardus pardalis, syn. Felis pardalis) covered with blackish ocellated spots and blotches which are variously arranged.
och: (i) general interjection of confirmation, affirmation, and often disapproval.; an expression of anger, frustration, surprise
Och: (N) A surname.
OCH: (n) 6-oxocamphor hydrolase
ocher: (n) Alternative spelling of ochre(v) Alternative spelling of ochre
ochre: (n) An earth pigment containing silica, aluminum and ferric oxide; A somewhat dark yellowish orange colour; The stop codon sequence "UAA."; Money, especially gold.; Any of various brown-coloured hesperiid butterflies of the genus Trapezites.(aj) Having a yellow-orange colour.; Referring to cultures that covered their dead with ochre.(v) To cover or tint with ochre.(n) Alternative form of okra.
ochrea: (n) Alternative form of ocrea; A greave or legging.
ocrea: (n) A sheath around a plant stem forming from the stipule of a leaf and extending above the point of insertion of the leaf.
octad: (n) A group of eight things.; hundred million = myriad myriad; 100,000,000 = 10⁸
octal: (n) The number system that uses the eight digits 0, 1, 2, 3, 4, 5, 6, 7.; A digit or value in the octal number system.(aj) Concerning numbers expressed in octal or mathematical calculations performed using octal.
octan: (aj) Occurring every eight days.(n) A fever that recurs every eight days.
octane: (n) Any of the eighteen isomeric aliphatic hydrocarbons (C₈H₁₈) found in petroleum, especially an iso-octane 2,2,4 trimethyl-pentane; they are used as fuels and solvents.
octans: (n) plural of octan
Octans: (N) A small circumpolar constellation of the southern sky, said to resemble an octant. It lies closest to the southern celestial pole of any constellation.
octant: (n) The eighth part of a circle; an arc of 45 degrees.; The aspect of two planets that are 45°, or one-eighth of a circle, apart.; The eighth part of a disc; a sector of 45 degrees; half a quadrant.; An instrument for measuring angles, particularly of elevation.
octave: (n) An interval of twelve semitones spanning eight degrees of the diatonic scale, representing a doubling or halving in pitch frequency.; The pitch an octave higher than a given pitch.; A coupler on an organ which allows the organist to sound the note an octave above the note of the key pressed (cf sub-octave); A poetic stanza consisting of eight lines; usually used as one part of a sonnet.; The eighth defensive position, with the sword hand held at waist height, and the tip of the sword out straight at knee level.; The day that is one week after a feast day in the Latin rite of the Catholic Church.; An eight-day period beginning on a feast day in the Latin rite of the Catholic Church.; An octonion.; Any of a number of coherent-noise functions of differing frequency that are added together to form Perlin noise.; The subjective vibration of a planet.(v) Alternative form of octavate(aj) Consisting of eight; eight in number.
octavo: (n) A sheet of paper 7 to 10 inches (= 17.78 to 25.4 cm) high and 4.5 to 6 inches (= 11.43 to 15.24 cm) wide, the size varying with the large original sheet used to create it. It is made by folding the original sheet three times to produce eight leaves.; A book of octavo pages.
octet: (n) A group or set of eight of something.; A group of eight musicians performing together.; A composition for such a group of musicians.; A byte of eight bits. Abbreviation: o; A group of three bits, representing any of eight possible values.
octroi: (n) A privilege granted by the sovereign authority, such as the exclusive right of trade granted to a guild or society; a concession.; A tax levied in money or kind at the gate of a French city on articles brought within the walls.
ocular: (aj) Of, or relating to the eye, or the sense of sight; Resembling the eye.; Seen by, or seeing with, the eye; visual.(n) The eyepiece of a microscope or other optical instrument.; Any of the scales forming the margin of a reptile's eye.
oculus: (n) A window or other opening that has an oval or circular shape (as of an eye).; The central boss of a volute.; A window or other opening that has an oval or circular shape (as of an eye).; An opening at the apex of a dome.
od: (n) (Euphemistic form of) God.(n) An alleged force or natural power, supposed, by Carl Reichenbach and others, to produce the phenomena of mesmerism, and to be developed by various agencies, as by magnets, heat, light, chemical or vital action, etc.
OD: (v) To take an overdose of a drug, to overdose.
Od: (N) A Indo-Aryan language spoken in Sindh and Punjab in Pakistan and Gujarat, Haryana, New Delhi and Rajasthan in India.
odd: (aj) Differing from what is usual, ordinary or expected.; Peculiar, singular and strange in looks or character; eccentric, bizarre.; Without a corresponding mate in a pair or set; unmatched; (of a pair or set) mismatched.; Left over, remaining after the rest have been paired or grouped.; Left over or remaining (as a small amount) after counting, payment, etc.; Scattered; occasional, infrequent; not forming part of a set or pattern.; Not regular or planned.; Used or employed for odd jobs.; Numerically indivisible by two.; Numbered with an odd number.; About, approximately; somewhat more than (an approximated round number).; Out of the way, secluded.; On the left.; Singular in excellence; matchless; peerless; outstanding.(n) An odd number.; Something left over, not forming part of a set.
odder: (aj) comparative form of odd: more odd
oddest: (aj) superlative form of odd: most odd
oddity: (n) An odd or strange thing or opinion.; A strange person; an oddball.; Strangeness.
oddly: (av) In a peculiar manner; strangely; unusually.; In a manner measured by an odd number.
odds: (n) The ratio of the probability of an event happening to that of it not happening.; The ratio of winnings to stake in betting situations.
ode: (n) A short poetical composition proper to be set to music or sung; a lyric poem; especially, now, a poem characterized by sustained noble sentiment and appropriate dignity of style.
Odense: (N) Odense, the largest city in Region of Southern Denmark (Region Syddanmark) and third-largest city in Denmark.; Odense Municipality (Odense Kommune), the municipality of which the city of Odense is administrative centre.
Oder: (N) A river in central Europe, that flows from the Czech Republic through Poland and Germany to the Baltic Sea.
odes: (n) plural of ode
odeum: (n) Alternative form of odeon
Odin: (N) A major Germanic god, in his Norse form a member of the Æsir, married to Frigg, and associated with knowledge, poetry, and war. Wednesday refers to him by way of interpretatio germanica.
odious: (aj) Arousing or meriting strong dislike, aversion, or intense displeasure.
odium: (n) Hatred; dislike.; The quality that provokes hatred; offensiveness.
odor: (n) Any smell, whether fragrant or offensive.; A strong, pervasive quality.; Esteem.; Something which produces a scent; incense, a perfume.
odour: (n) Alternative form of odor
odours: (n) plural of odour
odyl: (n) od (hypothetical force)
odyls: (n) plural of odyl
oe: (n) A small island.(n) A grandchild.
oedema: (n) Alternative form of edema
oeuvre: (n) A work of art.; The complete body of an artist's work.
of: (p) Expressing distance or motion.; From (of distance, direction), "off".; Expressing distance or motion.; Since, from (a given time, earlier state etc.).; Expressing distance or motion.; From, away from (a position, number, distance etc.).; Expressing distance or motion.; Before (the hour); to.; Expressing separation.; Indicating removal, absence or separation, with the action indicated by a transitive verb and the quality or substance by a grammatical object.; Expressing separation.; Indicating removal, absence or separation, with resulting state indicated by an adjective.; Expressing separation.; Indicating removal, absence or separation, construed with an intransitive verb.; Expressing origin.; Indicating an ancestral source or origin of descent.; Expressing origin.; Introducing an epithet that indicates a birthplace, residence, dominion, or other place associated with the individual.; Expressing origin.; Indicating a (non-physical) source of action or emotion; introducing a cause, instigation; from, out of, as an expression of.; Expressing origin.; Indicates the source or cause of the verb.; Expressing origin.; Indicates the subject or cause of the adjective.; Expressing agency.; Indicates the agent (for most verbs, now usually expressed with by).; Expressing agency.; Used to introduce the "subjective genitive"; following a noun to form the head of a postmodifying noun phrase (see also 'Possession' senses below).; Expressing agency.; Used to indicate the agent of something described by the adjective.; Expressing composition, substance.; Used to indicate the material or substance used.; Expressing composition, substance.; Used to indicate the material of the just-mentioned object.; Expressing composition, substance.; Indicating the composition of a given collective or quantitative noun.; Expressing composition, substance.; Used to link a given class of things with a specific example of that class.; Expressing composition, substance.; Links two nouns in near-apposition, with the first qualifying the second; "which is also".; Introducing subject matter.; Links an intransitive verb, or a transitive verb and its subject (especially verbs to do with thinking, feeling, expressing etc.), with its subject-matter; concerning, with regard to.; Introducing subject matter.; Introduces its subject matter; about, concerning.; Introducing subject matter.; Introduces its subject matter.; Having partitive effect.; Introduces the whole for which is indicated only the specified part or segment; "from among".; Having partitive effect.; Indicates a given part.; Having partitive effect.; Some, an amount of, one of.; Having partitive effect.; Links to a genitive noun or possessive pronoun, with partitive effect (though now often merged with possessive senses, below).; Expressing possession.; Belonging to, existing in, or taking place in a given location, place or time. Compare "origin" senses, above.; Expressing possession.; Belonging to (a place) through having title, ownership or control over it.; Expressing possession.; Belonging to (someone or something) as something they possess or have as a characteristic; the "possessive genitive". (With abstract nouns, this intersects with the subjective genitive, above under "agency" senses.); Forming the "objective genitive".; Follows an agent noun, verbal noun or noun of action.; Expressing qualities or characteristics.; Links an adjective with a noun or noun phrase to form a quasi-adverbial qualifier; in respect to, as regards.; Expressing qualities or characteristics.; Indicates a quality or characteristic; "characterized by".; Expressing qualities or characteristics.; Indicates quantity, age, price, etc.; Expressing qualities or characteristics.; Used to link singular indefinite nouns (preceded by the indefinite article) and attributive adjectives modified by certain common adverbs of degree.; Expressing a point in time.; During the course of (a set period of time, day of the week etc.), now specifically with implied repetition or regularity.; Expressing a point in time.; For (a given length of time).; Expressing a point in time.; Indicates duration of a state, activity etc.; Expressing a point in time.; Denotes the number of minutes before the hour(v) Eye dialect spelling of have or ’ve, chiefly in depictions of colloquial speech.
ofay: (n) A white person.(aj) White; white-skinned.
off: (av) In a direction away from the speaker or other reference point.; Into a state of non-operation or non-existence.; So as to remove or separate, or be removed or separated.; Offstage.; Used in various other ways specific to individual idiomatic phrases, e.g. bring off, show off, put off, tell off, etc. See the entry for the individual phrase.(aj) Inoperative, disabled.; Cancelled; not happening.; Not fitted; not being worn.; Rancid, rotten, gone bad.; Disgusting, repulsive, abhorrent.; Less than normal, in temperament or in result.; Inappropriate; untoward.; Circumstanced.; Started on the way.; Far; off to the side.; Designating a time when one is not strictly attentive to business or affairs, or is absent from a post, and, hence, a time when affairs are not urgent.; Designating a time when one is not performing to the best of one's abilities.; Presently unavailable.; On the side furthest from the kerb (the right-hand side if one drives on the left).; In, or towards the half of the field away from the batsman's legs; the right side for a right-handed batsman.(p) Not positioned upon, or away from a position upon.; Detached, separated, excluded or disconnected from; away from a position of attachment or connection to.; Used to indicate the location or direction of one thing relative to another, implying adjacency or accessibility via.; Used to express location at sea relative to land or mainland.; Removed or subtracted from.; No longer wanting or taking.; Out of the possession of.; Placed after a number (of products or parts, as if a unit), in commerce or engineering.(v) To kill.; To switch off.(n) Beginning; starting point.
offal: (n) The internal organs of an animal, used as animal food.; A by-product of the grain milling process, which may include bran, husks, etc.; A dead body; carrion.; That which is thrown away as worthless or unfit for use; refuse; rubbish.
offend: (v) To hurt the feelings of; to displease; to make angry; to insult.; To feel or become offended; to take insult.; To physically harm, pain.; To annoy, cause discomfort or resent.; To sin, transgress divine law or moral rules.; To transgress or violate a law or moral requirement.; To cause to stumble; to cause to sin or to fall.
offer: (n) A proposal that has been made.; Something put forth, bid, proffered or tendered.; An invitation to enter into a binding contract communicated to another party which contains terms sufficiently definite to create an enforceable contract if the other party accepts the invitation.(v) To propose or express one's willingness (to do something).; To present in words; to proffer; to make a proposal of; to suggest.; To place at someone’s disposal; to present (something) to be either accepted or turned down.; To present (something) to God or gods as a gesture of worship, or for a sacrifice.; To place (something) in a position where it can be added to an existing mechanical assembly.; To bid, as a price, reward, or wages.; To happen, to present itself.; To make an attempt; typically used with at.; To put in opposition to; to manifest in an offensive way; to threaten.(n) agent noun of off
Offer: (N) A surname.
offers: (n) plural of offer(v) Third-person singular simple present indicative form of offer
Offers: (N) plural of Offer
office: (n) A ceremonial duty or service; The authorized form of ceremonial worship of a church.; A ceremonial duty or service; Any special liturgy, as the Office for the Dead or of the Virgin.; A ceremonial duty or service; A daily service without the eucharist.; A ceremonial duty or service; The daily service of the breviary, the liturgy for each canonical hour, including psalms, collects, and lessons.; A ceremonial duty or service; Various prayers used with modification as a morning or evening service.; A ceremonial duty or service; Last rites.; A ceremonial duty or service; Mass, (particularly) the introit sung at its beginning.; A position of responsibility.; Official position, particularly high employment within government; tenure in such a position.; A duty, particularly owing to one's position or station; a charge, trust, or role; (obsolete, rare) moral duty.; Function: anything typically done by or expected of something.; A service, a kindness.; Inside information.; A room, set of rooms, or building used for non-manual work; A room, set of rooms, or building used for administration and bookkeeping.; A room, set of rooms, or building used for non-manual work; A room, set of rooms, or building used for selling services or tickets to the public.; A room, set of rooms, or building used for non-manual work; A room, set of rooms, or building used for consultation and diagnosis, but not surgery or other major procedures.; The staff of such places.; The administrative departments housed in such places; A ministry or other department of government.; The administrative departments housed in such places; Short for Holy Office: the court of final appeal in cases of heresy.; The administrative departments housed in such places; A particular place of business of a larger white-collar business.; The parts of a house or estate devoted to manual work and storage, as the kitchen, scullery, laundry, stables, etc., particularly (euphemistic, dated) a house or estate's facilities for urination and defecation: outhouses or lavatories.; Clipping of inquest of office: an inquest undertaken on occasions when the Crown claimed the right of possession to land or property.; A piece of land used for hunting; the area of land overseen by a gamekeeper.; A hangout: a place where one is normally found.; A plane's cockpit, particularly an observer's cockpit.; A collection of business software typically including a word processor and spreadsheet and slideshow programs.; An official or group of officials; (figuratively) a personification of officeholders.; A bodily function, (particularly) urination and defecation; an act of urination or defecation.; The performance of a duty; an instance of performing a duty.(v) To provide (someone) with an office.; To have an office.
offing: (n) The area of the sea in which a ship can be seen in the distance from land, excluding the parts nearest the shore, and beyond the anchoring ground.; The distance that a ship at sea keeps away from land, often because of navigational dangers, fog and other hazards; a position at a distance from shore.; The foreseeable future. Chiefly in the phrase in the offing.(v) present participle of off
offish: (aj) aloof
offset: (n) Anything that acts as counterbalance; a compensating equivalent.; A form of countertrade arrangement, in which the seller agrees to purchase within a set time frame products of a certain value from the buying country. This kind of agreement may be used in large international public sector contracts such as arms sales.; A time at which something begins; outset.; The offset printing process, in which ink is carried from a metal plate to a rubber blanket and from there to the printing surface.; The difference between a target memory address and a base address.; The displacement between the base level of a measurement and the signal's real base level.; The distance by which one thing is out of alignment with another.; A short distance measured at right angles from a line actually run to some point in an irregular boundary, or to some object.; An abrupt bend in an object, such as a rod, by which one part is turned aside out of line, but nearly parallel, with the rest; the part thus bent aside.; A short prostrate shoot that takes root and produces a tuft of leaves, etc.; A spur from a range of hills or mountains.; A horizontal ledge on the face of a wall, formed by a diminution of its thickness, or by the weathering or upper surface of a part built out from it; a set-off.; A terrace on a hillside.; away from or off from the general locations and area where a movie’s, a film‘s, or a video’s scenery is arranged to be filmed or from those places for actors, assorted crew, director, producers which are typically not filmed.(v) To counteract or compensate for, by applying a change in the opposite direction.; To place out of line.; To form an offset in (a wall, rod, pipe, etc.).
oft: (av) often; frequently; not rarely
often: (av) Frequently; many times.(aj) Frequent.
ogdoad: (n) A thing made up of eight parts.
Ogdoad: (N) The group of eight primordial deities worshipped at Hermopolis in Ancient Egyptian times: Naunet and Nu, Amaunet and Amun, Kauket and Kuk, and Hauhet and Huh.
ogee: (n) A double curve in the shape of an elongated S; an object of that shape.; A pointed arch made from two ogees.; An inflection point.; The malar or cheekbone prominence transitioning into the mid-cheek hollow.; The bubble-shaped chamber of a pot still that connects the swan neck to the pot and allows distillate to expand, condense, and fall back into the pot.
ogham: (n) Alternative form of Ogham(N) Alternative form of Ogham
Ogham: (N) An ancient Celtic alphabet historically used to write Primitive Irish.(n) A single character in this alphabet.
ogive: (n) The curve of a cumulative distribution function.; A Gothic pointed arch, or a rib of a Gothic vault.; The pointed, curved nose of a bullet, missile, or rocket.; A three-dimensional wave-bulge, characteristic of glaciers that have experienced extreme underlying topographic change.
ogle: (v) To stare at (someone or something), especially impertinently, amorously, or covetously.(n) An impertinent, flirtatious, amorous or covetous stare.; An eye.
Ogle: (N) A surname.; A village in Northumberland, England (OS grid ref NZ1378).; An unincorporated community in Clay County, Kentucky, United States.
ogling: (n) Action of the verb to ogle.(v) present participle of ogle
ogre: (n) A type of brutish giant from folk tales that eats human flesh.; A brutish man reminiscent of the mythical ogre.
Ogre: (N) A town in central Latvia
oh: (i) Expression of surprise.; Expression of wonder, amazement, or awe.; Expression of understanding, affirmation, recognition, or realization.; A word to precede an offhand or annoyed remark.; A word to precede an added comment or afterthought.; An invocation or address (similar to the vocative in languages with noun declension), often with a term of endearment.; Exclamation for drama or emphasis (often poetic).; Expression of pain. See ouch.; Space filler or extra syllable, especially in (popular) music.; Expression of mild scepticism.; A word to mark a spoken phrase as imaginary.(n) An utterance of oh; a spoken expression of surprise, acknowledgement, etc.(v) To utter the interjection oh; to express surprise, etc.(n) the letter O, o (more commonly spelled o)(n) the digit 0 (especially in representations of speech)
OH: (S) A hydroxyl, or alcohol, functional group.; A hydroxide radical, or hydroxyl group.
Oh: (N) A surname, from Korean derived from a common Korean surname.(N) A surname, from Chinese.
ohm: (n) In the International System of Units, the derived unit of electrical resistance; the electrical resistance of a device across which a potential difference of one volt causes a current of one ampere. Symbol: Ω
ohmage: (n) An amount of electrical resistance measured in ohms.
oho: (i) Expressing surprise or gloating realisation; aha.
oi: (i) Said to get someone's attention; hey.; An expression of surprise.; An informal greeting, similar to hi.(n) A working-class punk rock subgenre of the 1970s, sometimes associated with racism.(i) Alternative spelling of oy(P) I.
Oi: (P) Pronunciation spelling of I.
oidium: (n) A fragile spore produced by some fungi.; The fungus Erysiphe necator (= Uncinula necator), which produces powdery mildew in grapes.
oil: (n) Liquid fat.; Petroleum-based liquid used as fuel or lubricant.; An oil painting.; Oil paint.; Containing oil, conveying oil; intended for or capable of containing oil.(v) To lubricate with oil.; To grease with oil for cooking.
oilcan: (n) A container with a long spout, for holding oil and delivering it in drops or small quantities for lubrication.
oilcup: (n) A device that dispenses oil for lubrication in an engine, etc., without the need for a human operator.
oiled: (v) simple past tense and past participle of oil(aj) Covered in, or supplied with, oil.; drunk. Usually in conjunction with well.
oiler: (n) One who or that which oils.; An assistant in the engine room of a ship, senior only to a wiper, mainly responsible for keeping machinery lubricated.; An oil tanker.; An oil well.; A small (typically thumb-sized) metal container of oil, often containing an integral brush.; An oilskin coat.; A Mexican.
oiling: (v) present participle of oil(n) An application of oil.
oils: (n) plural of oil(v) Third-person singular simple present indicative form of oil
oily: (aj) Relating to or resembling oil.; Covered with or containing oil.; Excessively friendly or polite but insincere.(n) A marble with an oily lustre.; Oilskins. (waterproof garment)
oink: (i) Representing the sound made by a pig.; Drawing attention to male chauvinism (from the term male chauvinist pig).(n) The sound made by a pig, or an imitation thereof.(v) Of a pig or in imitation thereof, to make its characteristic sound.
OIS: (n) An officer-involved shooting.
Ojibwa: (N) Alternative form of Ojibwe
ok: (aj) Alternative letter-case form of OK
OK: (n) Endorsement; approval.(v) To approve.; To confirm by activating a button marked OK.(aj) All right, acceptable, permitted.; Satisfactory, reasonably good; not exceptional.; In good health or a good emotional state.(av) Satisfactorily, sufficiently well.(i) Used to indicate acknowledgement or acceptance.; Used to introduce a sentence in order to draw attention to the importance of what is being said.; Used in turn-taking, serving as a request to the speaker to grant the turn to the interrupter.(N) United States postal abbreviation for Oklahoma, a state of the United States of America.
Ok: (N) A language family spoken in Papua New Guinea.(i) Alternative form of OK (okeh)
oka: (n) A former Turkish, Egyptian, Hungarian, and Romanian unit of weight, usually of a little more than a kilogram.; A unit of volume in Egypt (and formerly Turkey) corresponding to about 1.2 litres.
Oka: (N) A river in central Russia, the largest right tributary of the Volga.(N) A small village, a suburb of Montreal, Quebec, Canada.(n) A kind of pungent, semi-soft cheese, originally made by Trappist monks in Oka, Quebec.(N) An ancient town in Bithynia, in modern Turkey.; The capital city of Akoko South-West, Ondo, Nigeria.; An unincorporated community in Calhoun County, West Virginia, United States.; A common family/surname among Marathi Chitpawan Brahmins of Western India. Also spelt as Oke and Oak.
okapi: (n) A large ruminant mammal, Okapia johnstoni, found in the rainforests of the Congo, related to the giraffe but with a much shorter neck, a reddish-brown coat, and zebra-like stripes on its hindquarters.
okay: (n) Alternative spelling of OK(v) Alternative spelling of OK(aj) Alternative spelling of OK(av) Alternative spelling of OK(i) Alternative spelling of OK
oke: (v) simple past tense of ache; simple past tense of ake(n) Alternative form of oka.(n) Man; guy; bloke.(n) Obsolete spelling of oak
okra: (n) The edible immature mucilaginous seed pod (properly, capsule) of the Abelmoschus esculentus.; The flowering mallow plant Abelmoschus esculentus itself, now commonly grown in the tropics and warmer parts of the temperate zones.
old: (aj) Of an object, concept, relationship, etc., having existed for a relatively long period of time.; Of a living being, having lived for most of the expected years.; Of an object, concept, relationship, etc., having existed for a relatively long period of time.; Of a perishable item, having existed for most, or more than its shelf life.; Having been used and thus no longer new or unused.; Having existed or lived for the specified time.; Of an earlier time.; Former, previous.; Of an earlier time.; That is no longer in existence.; Of an earlier time.; Obsolete; out-of-date.; Of an earlier time.; Familiar.; Of an earlier time.; Being a graduate or alumnus of a school, especially a public school.; Tiresome after prolonged repetition.; Said of subdued colors, particularly reds, pinks and oranges, as if they had faded over time.; A grammatical intensifier, often used in describing something positive. (Mostly in idioms like good old, big old and little old, any old and some old.); Excessive, abundant.(n) People who are old; old beings; the older generation, taken as a group.; A person older than oneself, especially an adult in relation to a teenager.; One's parents.
olden: (aj) From or relating to a previous era.; Old; ancient.(v) To grow old; age; assume an older appearance or character; become affected by age.
Olden: (N) A surname.; An unincorporated community in Howell County, Missouri, United States.; An unincorporated community in Eastland County, Texas, United States
older: (aj) comparative form of old: more old, elder, senior(aj) elderly
oldest: (aj) superlative form of old: most old(n) The oldest child in a family, or individual in a group.
Oldham: (N) A town and metropolitan borough in Greater Manchester, England (OS grid ref SD922053).; A community in the Regional Municipality of Halifax, Nova Scotia, Canada.; An unincorporated community in Tishomingo County, Mississippi, United States.; An unincorporated community in Boone County, Missouri, United States.; A minor city in Kingsbury County, South Dakota, United States.; A habitational surname.
oldie: (n) Something or someone old.; A song or record from a previous era.; The genre of music composed of popular music from previous eras.
oldish: (aj) somewhat old
oleate: (n) any salt or ester of oleic acid
oleic: (aj) Of or pertaining to oil, especially to vegetable oil; Of or pertaining to oleic acid or its derivatives
olein: (n) Any naturally-occurring greasy or oily substance related to fat; Any glyceride of oleic acid
oleo: (n) A type of energy-absorbing landing gear strut in which sudden compression or extension of the strut causes a gas-filled chamber to push or pull a piston which forces oil through a small orifice, resulting in absorption of energy through viscous effects.(n) The various fats and oils that go into the making of margarine.(n) margarine
oleum: (n) A solution of sulfur trioxide in sulfuric acid.
olid: (aj) evil-smelling; fetid.
olio: (n) A rich, thick, Spanish stew consisting of meat and vegetables.; A medley or mixture; a hotchpotch.; A collection of various musical, theatrical or other artistic works; a miscellany.; Vaudeville or similar miscellaneous musical or theatrical entertainment skits presented between the main acts of burlesque or minstrel shows.
olive: (n) A tree, Olea europaea, cultivated since ancient times in the Mediterranean for its fruit and the oil obtained from it.; The small oval fruit of this tree, eaten ripe (usually black) or unripe (usually green).; The wood of the olive tree.; A dark yellowish-green color, that of an unripe olive.; An olivary body, part of the medulla oblongata.; A component of a plumbing compression joint; a ring which is placed between the nut and the pipe and compressed during fastening to provide a seal.; A small slice of meat seasoned, rolled up, and cooked.; Any shell of the genus Oliva and allied genera; so called from the shape.; An oystercatcher, a shore bird.(aj) Of a grayish green color, that of an unripe olive.
Olive: (N) A female given name from English.; A surname.; A male given name from English.
oliver: (n) A small tilt hammer, worked by the foot.
Oliver: (N) A male given name from the Germanic languages.; A patronymic surname, from given names.; A number of places in Canada:; A town in British Columbia.; A number of places in Canada:; An urban neighborhood of Edmonton, Alberta.; A number of places in Canada:; A community in Colchester County, Nova Scotia.; A number of places in Canada:; A community in Essex County, Ontario.; A number of places in the United States:; An unincorporated community in Scott County, Arkansas.; A number of places in the United States:; A ghost town in Yuba County, California.; A number of places in the United States:; A tiny city in Screven County, Georgia.; A number of places in the United States:; An unincorporated community in Edgar County, Illinois.; A number of places in the United States:; An unincorporated community in Whiteside County, Illinois.; A number of places in the United States:; An unincorporated community in Posey County, Indiana.; A number of places in the United States:; A neighborhood of Baltimore, Maryland.; A number of places in the United States:; An unincorporated community in Kimball County, Nebraska.; A number of places in the United States:; A census-designated place in Fayette County, Pennsylvania.; A number of places in the United States:; A village in Douglas County, Wisconsin.; The Moon.(aj) Drunk, pissed.
olives: (n) plural of olive
olla: (n) A cooking-pot or earthenware jar used in Spain and Spanish-speaking countries.; A pot used for cooling water by evaporation in Latin America.; An unglazed earthenware pot, buried to provide slow steady irrigation.; A cinerary urn in ancient Rome.
ology: (n) Any branch of learning, especially one ending in “-logy”.
om: (n) A sacred, mystical syllable used in prayer and meditation.(v) To chant the sacred syllable om.(i) Clipping of nom.
Omaha: (n) A member of a tribe of Native Americans currently residing in northeastern Nebraska and western Iowa.(N) The largest city in Nebraska, United States, and the county seat of Douglas County.; The language spoken by the Omaha tribe.; Omaha hold 'em, any of several poker variants.
Oman: (N) A country in the Middle East. Official name: Sultanate of Oman
omasum: (n) The third compartment of the stomach of a ruminant; the lining of said compartment, regarded as a foodstuff.
ombre: (n) A Spanish card game, usually played by three people. It involves forty cards, omitting the ranks of 8, 9 and 10.(n) A large Mediterranean food fish Umbrina cirrosa(n) A gradual blending of one color hue to another, usually moving tints and shades from light to dark.
omega: (n) The twenty-fourth letter of the Classical and the Modern Greek alphabet, and the twenty-eighth letter of the Old and the Ancient Greek alphabet, i.e. the last letter of every Greek alphabet. Uppercase version: Ω; lowercase: ω.; The end; the final, last or ultimate in a sequence.; Angular velocity; symbol: ω.; An omega male.; The percentage change in an option value divided by the percentage change in the underlying asset's price.; In omegaverse fiction, a person of a submissive secondary sex driven by biology, magic, or other means to bond with an alpha, with males of this type often being able to get pregnant.
omelet: (n) Alternative form of omelette
omen: (n) Something which portends or is perceived to portend either a good or evil event or circumstance in the future, or which causes a foreboding; a portent or augury.; A thing of prophetic significance.(v) To be an omen of.; To divine or predict from omens.
omens: (n) plural of omen(v) Third-person singular simple present indicative form of omen
omer: (n) A former small Hebrew unit of dry volume equal to about 2.3 L or 2.1 quarts.; A vessel of one omer.; The sheaf of barley offered on the second day of Passover.(n) The counting of the omer, that is, the period of 49 days between Passover and Shavuot.
Omer: (n) The 49-day period from the second day of Passover to Pentecost, begun and ended with an offering of a sheaf of barley and noted nightly during evening prayer.; Alternative form of omer: the sheaf of barley offered on the second day of Passover.(N) A masculine name included within a Biblical genealogy as a descendant of Esau at Genesis 36:11.
omit: (v) To leave out or exclude.; To fail to perform.; To delete or remove; to strike.; To neglect or take no notice of.
omits: (v) Third-person singular simple present indicative form of omit
omnium: (n) A multiple race event in track cycling. Historically the omnium has had a variety of formats. Currently it consists of the following six events: flying lap, points race, elimination, individual pursuit, scratch race, and time trial.; The aggregate value of the different stocks in which a loan to government is usually funded.
Omsk: (N) An oblast of Russia.; A city, the administrative center of Omsk Oblast, Russia, the seventh-largest in the country by population.
on: (aj) In the state of being active, functioning or operating.; Performing according to schedule; taking place.; Fitted; covering; being worn.; Of a stated part of something, oriented towards the viewer or other specified direction.; Acceptable, appropriate.; Destined, normally in the context of a challenge being accepted; involved, doomed.; Having reached a base as a runner and being positioned there, awaiting further action from a subsequent batter.; Within the half of the field on the same side as the batsman's legs; the left side for a right-handed batsman.; Menstruating.(av) To an operating state.; So as to cover or be fitted.; Along, forwards (continuing an action).; In continuation, at length.; Later.; Of betting odds, denoting a better-than-even chance. See also odds-on.(p) Positioned at the upper surface of, touching from above.; Positioned at or resting against the outer surface of; attached to.; Expressing figurative placement or attachment.; Denoting performance or action by contact with the surface, upper part, or outside of anything; hence, by means of; with.; At or in (a certain region or location).; Near; adjacent to; alongside.; Supported by (the specified part of itself).; So as to impart force to.; So as to impact; against.; Covering.; Inside (a vehicle) for the purpose of travelling.; At the date of.; Some time during the day of.; At a given time after the start of something; at.; Dealing with the subject of; about; concerning.; In the possession of.; Because of, or due to.; Upon; at the time of (and often because of).; Paid for by.; Indicating a means or medium.; Indicating the target of, or thing affected by, an event or action.; Toward; for; indicating the object of an emotion.; Indicating a means of subsistence.; Engaged in or occupied with (an action or activity).; Regularly taking (a drug).; Under the influence of (a drug).; Having identical domain and codomain.; Having Vⁿ as domain and V as codomain, for some set V and integer n.; Generated by.; In addition to; besides; indicating multiplication or succession in a series.; of; Indicating dependence or reliance.; At the peril of, or for the safety of.; Serving as a member of.; By virtue of; with the pledge of.; To the account or detriment of; denoting imprecation or invocation, or coming to, falling, or resting upon.; Against; in opposition to.(v) to switch on(p) Without.(n) In the Japanese language, a pronunciation, or reading, of a kanji character that was originally based on the character's pronunciation in Chinese, contrasted with kun.
onager: (n) The Asiatic wild ass or hemione (Equus hemionus), an animal of the horse family native to Asia; specifically, the Persian onager, Persian wild ass, or Persian zebra (Equus hemionus onager).; A military engine acting like a sling which threw stones from a bag or wooden bucket powered by the torsion from a bundle of ropes or sinews operated by machinery; a torsion catapult.
once: (av) One and only one time.; Formerly; during some period in the past.; At any time; ever.; One day, someday.; Multiplied by one: indicating that a number is multiplied by one.(c) As soon as; when; after.
onces: (n) plural of once
one: (0) The number represented by the Arabic numeral 1; the numerical value equal to that cardinal number.; The first positive number in the set of natural numbers.; The cardinality of the smallest nonempty set.; The ordinality of an element which has no predecessor, usually called first or number one.(P) One thing (among a group of others); one member of a group.; The first mentioned of two things or people, as opposed to the other.; Any person (applying to people in general).; Any person, entity or thing.; it can be used as a gender-neutral singular personal pronoun, especially in formal speech or writing, instead of they. See Usage Notes below.(n) The digit or figure 1.; The neutral element with respect to multiplication in a ring.; A one-dollar bill.; One o'clock, either a.m. or p.m.; One run scored by hitting the ball and running between the wickets; a single.; A joke or amusing anecdote.; A particularly special or compatible person or thing.; (euphemistic or derogatory) A gay person.; Used instead of ! to amplify an exclamation, parodying unskilled typists who forget to press the shift key while typing exclamation points, thus typing "1".(aj) Of a period of time, being particular.; Being a single, unspecified thing; a; any.; Sole, only.; Whole, entire.; In agreement.; The same.; Being a preeminent example.; Being an unknown person with the specified name; see also "a certain".(v) To cause to become one; to gather into a single whole; to unite.
ones: (n) plural of one(P) plural of one; Obsolete form of one's.
onion: (n) A monocotyledonous plant (Allium cepa), allied to garlic, used as vegetable and spice.; The bulb of such a plant.; The genus Allium as a whole.; An ounce.; A ball.; A person from Bermuda or of Bermudian descent.; A watch-seal.
onioning: (v) plural of onion
onions: (n) plural of onion
Onions: (N) A patronymic surname, from Welsh.
only: (aj) Alone in a category.; Singularly superior; the best.; Without sibling; without a sibling of the same gender.; Mere.(av) Without others or anything further; exclusively.; No more than; just.; As recently as.; Used to express surprise or consternation at an action.; Introduces a disappointing or surprising outcome that renders futile something previously mentioned.; Above all others; particularly.(c) Under the condition that; but.; But; except.(n) An only child.
onrush: (n) A forceful rush or flow forward.; An aggressive assault.(v) To rush or flow forward forcefully.; To assault aggressively.
ons: (v) Third-person singular simple present indicative form of on
onset: (n) An attack; an assault especially of an army.; The initial phase of a disease or condition, in which symptoms first become apparent.; The initial portion of a syllable, preceding the syllable nucleus.; The beginning of a musical note or other sound, in which the amplitude rises from zero to an initial peak.; A setting about; a beginning.; Anything added, such as an ornament or as a useful appendage.(v) To assault; to set upon.; To set about; to begin.
onto: (p) Upon; on top of.; Aware of.; Being an onto function with a codomain of (see below).(aj) Assuming each of the values in its codomain; having its range equal to its codomain.
onus: (n) A legal obligation.; Burden of proof, onus probandi.; Stigma.; Blame.; Responsibility; burden.
onward: (aj) Moving forward.; Advanced in a forward direction or toward an end.(av) In a forward direction.(v) To keep going; to progress or persevere.
onyx: (n) A banded variety of chalcedony, a cryptocrystalline form of quartz.; A jet-black color, named after the gemstone.; Any of various lycaenid butterflies of the genus Horaga.(aj) jet-black
Onyx: (N) A census-designated place in Kern County, California, United States.
oo: (n) The Greek letter omega.(n) Any of four Hawaiian birds of the genus Moho, formerly classed with the honeyeaters and now believed to be extinct.(i) Alternative form of ooh
OO: (n) Alternative letter-case form of oo
oocyte: (n) A cell that develops into an egg or ovum; a female gametocyte.
oof: (i) A sound mimicking the loss of air, as if someone's solar plexus had just been struck.; Synonym of ouch (“expressing sympathy at another's pain, shock at a high price, etc.”)(n) A sound made in pain, as when expelling air after being struck.(n) Money.
oolite: (n) A rock consisting of spherical grains within a mineral cortex accreted around a nucleus, often of quartz grains.; An ooid or oolith.
oologies: (n) plural of oology
oology: (n) The study of birds' eggs.; The hobby or practice of collecting birds' eggs, especially those of wild birds.
oom: (n) An older man, especially an uncle. (Frequently as a respectful form of address.)
oomph: (n) Strength, power, passion or effectiveness; clout.; Sex appeal.; A bassy grunting or thudding sound.(v) To produce a bassy grunting or thudding sound.
oops: (i) Acknowledging a mistake.(n) A minor mistake or unforseen difficulty.(v) To make a mistake; to blunder.
OOPs: (v) Third-person singular simple present indicative form of OOP
ootid: (n) The haploid cell, produced by meiotic division of a secondary oocyte, that is a nearly mature ovum.
ooze: (n) Tanning liquor, an aqueous extract of vegetable matter (tanbark, sumac, etc.) in a tanning vat used to tan leather.; An oozing, gentle flowing, or seepage, as of water through sand or earth.; Secretion, humour.; Juice, sap.(v) To be secreted or slowly leak.; To give off a strong sense of (something); to exude.(n) Soft mud, slime, or shells especially in the bed of a river or estuary.; A pelagic marine sediment containing a significant amount of the microscopic remains of either calcareous or siliceous planktonic debris organisms.; A piece of soft, wet, pliable ground.
oozed: (v) simple past tense and past participle of ooze
oozes: (v) Third-person singular simple present indicative form of ooze(n) plural of ooze
oozing: (v) present participle of ooze(n) Something that oozes; a seepage.; Synonym of stringing (“defect in 3D printing”)
oozy: (aj) Of or pertaining to the quality of something that oozes.
op: (n) An operation.; An amateur radio operator.; An operator on IRC, who can moderate the chat channel, ban users, etc.; Op art; a style of abstract art.(v) To promote (an IRC user) to an operator.(n) Alternative letter-case form of OP (“original post, original poster”)(n) Clipping of opposition.(v) To buy (something) from an op shop.; To shop at op shops.
opah: (n) Any of various large, colourful, deep-bodied pelagic fish of the family Lamprididae.
opal: (n) A mineral consisting, like quartz, of silica, but inferior to quartz in hardness and specific gravity, of the chemical formula SiO₂·nH₂O.; A precious gem, an iridescent gemstone found in the opal-silica mineral substrate (potch); A colloquial name used in molecular biology referring to a particular stop codon sequence, "UGA."; Any of various lycaenid butterflies of the genus Nesolycaena.
Opal: (N) A female given name from English from the precious stone, invented in the nineteenth century.; A type of petrol made by British Petroleum designed to be unable to be used for petrol sniffing.; A hamlet in Alberta, Canada; A census-designated place in Virginia; A town in Wyoming
opals: (n) plural of opal
Opals: (N) The women's national basketball representative team of Australia.
opaque: (aj) Neither reflecting nor emitting light.; Allowing little light to pass through, not translucent or transparent.; Unclear, unintelligible, hard to get or explain the meaning of; Obtuse, stupid.; Describes a type for which higher-level callers have no knowledge of data values or their representations; all operations are carried out by the type's defined abstract operators.(n) An area of darkness; a place or region with no light.; Something which is opaque rather than translucent.(v) To make, render (more) opaque.
ope: (n) alley or narrow passage e.g. Tonkin's Ope(i) an exclamation of surprise; oops(aj) Open.(v) To open.
open: (aj) Not closed.; Able to be accessed.; Not closed.; Able to have something pass through or along it.; Not closed.; not covered, showing what is inside; Not physically drawn together, closed, folded or contracted; extended; Actively conducting or prepared to conduct business.; Receptive.; Public; Candid, ingenuous, not subtle in character.; Having a free variable.; Which is part of a predefined collection of subsets of X, that defines a topological space on X.; Whose first and last vertices are different.; In current use; mapped to part of memory.; To be in a position allowing fluid to flow.; To be in a position preventing electricity from flowing.; Not fulfilled.; Not settled or adjusted; not decided or determined; not closed or withdrawn from consideration.; Of a note, played without pressing the string against the fingerboard.; Of a note, played without closing any finger-hole, key or valve.; Not of a quality to prevent communication, as by closing waterways, blocking roads, etc.; hence, not frosty or inclement; mild; used of the weather or the climate.; Written or sent with the intention that it may made public or referred to at any trial, rather than by way of confidential private negotiation for a settlement.; Uttered with a relatively wide opening of the articulating organs; said of vowels.; Uttered, as a consonant, with the oral passage simply narrowed without closure.; That ends in a vowel; not having a coda.; Made public, usable with a free licence and without proprietary components.; Resulting from an incision, puncture or any other process by which the skin no longer protects an internal part of the body.; Source code of a computer program that is not within the text of a macro being generated.; Having component words separated by spaces, as opposed to being joined together or hyphenated; for example, time slot as opposed to timeslot or time-slot.(v) To make something accessible or allow for passage by moving from a shut position.; To make (an open space, etc.) by clearing away an obstacle or obstacles, in order to allow for passage, access, or visibility.; To move to a position allowing fluid to flow.; To move to a position preventing electricity from flowing.; To turn on; to switch on.; To bring up, broach.; To enter upon, begin.; To spread; to expand into an open or loose position.; To make accessible to customers or clients.; To start (a campaign).; To become open.; To begin conducting business.; To begin a side's innings as one of the first two batsmen.; To bet before any other player has in a particular betting round in a game of poker.; To reveal one's hand.; To load into memory for viewing or editing.; To disclose; to reveal; to interpret; to explain.(n) Open or unobstructed space; an exposed location.; Public knowledge or scrutiny; full view.; A defect in an electrical circuit preventing current from flowing.; A sports event in which anybody can compete.; The act of something being opened, such as an e-mail message.
opened: (v) simple past tense and past participle of open
opener: (n) A person who opens something.; A device that opens something; specifically a tin-opener/can-opener, or a bottle opener.; An establishment that opens.; The player who starts the betting.; Cards of sufficient value to enable a player to open the betting.; A person employed to separate sheets of hot metal that become stuck together.; The first act in a variety show or concert.; A batsman who normally plays in the first two positions of an innings.; The first in a series of events, items etc.; the first remark or sentence of a conversation.; The first game played in a competition.; The first goal or point scored.; A period of time when it is legal to commercially fish.; A pitcher who specializes in getting the first outs of a game before being replaced, either by a long reliever or a pitcher who would normally start.
openly: (av) In an open manner, visibly, not covertly.
opens: (n) plural of open(v) Third-person singular simple present indicative form of open
opera: (n) A theatrical work, combining drama, music, song and sometimes dance.; The score for such a work.; A building designed for the performance of such works; an opera house.; A company dedicated to performing such works.; Any showy, melodramatic or unrealistic production resembling an opera.(n) plural of opus; a collection of work.
operas: (n) plural of opera
operon: (n) A unit of genetic material that functions in a coordinated manner by means of an operator, a promoter, and structural genes that are transcribed together.
opes: (v) Third-person singular simple present indicative form of ope
Ophir: (N) A city or region mentioned in the Bible, famous for its gold.; A locality in Cabonne Council, New South Wales, Australia.; A sparsely populated farming community in Algoma District, Ontario, Canada.; A small settlement in Central Otago, New Zealand.; A ghost town in Yukon-Koyukuk Census Area, Alaska.; An unincorporated community in Placer County, California.; A town and home rule municipality of San Miguel County, Colorado.; An unincorporated community in Morgan County, Kentucky.; An unincorporated community in Curry County, Oregon.; A tiny town in Tooele County, Utah; suburb of Salt Lake City.
ophite: (n) Any of various rocks having snake-like markings, such as a mottled greenish porphyry.(aj) Serpent-like; ophidian.
Ophite: (n) A member of a Gnostic snake-worshipping sect of the second century.
opiate: (aj) Relating to, resembling, or containing opium.; Soporific; inducing sleep or sedation.; Deadening; causing apathy or dullness.(n) A drug, hormone or other substance derived from or related to opium.; Something that dulls the senses and induces a false and unrealistic sense of contentment.(v) To treat with an opiate drug.
opine: (v) To have or express an opinion; to state as an opinion; to suppose, consider (that).; To give one's formal opinion (on or upon something).(n) Any of a class of organic compounds, derived from amino acids, found in some plant tumours
opined: (v) simple past tense and past participle of opine
opium: (n) A yellow-brown, addictive narcotic drug obtained from the dried juice of unripe pods of the opium poppy, Papaver somniferum, and containing alkaloids such as morphine, codeine, and papaverine.; Anything that numbs or stupefies.
Oporto: (N) alternative name for Porto, the second-largest city of Portugal.
oppose: (v) To attempt to stop the progression of; to resist or antagonize by physical means, or by arguments, etc.; to contend against.; To object to.; To present or set up in opposition; to pose.; To place in front of, or over against; to set opposite; to exhibit.
oppugn: (v) To contradict or controvert; to oppose; to challenge or question the truth or validity of a given statement.
ops: (n) plural of op(n) operations; operator status(v) Third-person singular simple present indicative form of op
Ops: (N) The goddess of earth and fertility. Equivalent to the Greek Rhea, Ops was the sister-wife of Saturn and mother of Jupiter. After Saturn learned of a prophecy that his children by Ops would overthrow him, he ate each of them just after they were born; however, Ops saved Jupiter by feeding Saturn a stone instead.
opt: (v) To choose; select.
OPT: (N) Alternative form of oPt
optic: (aj) Of, or relating to the eye or to vision.; Of, or relating to optics or optical instruments.(n) An eye.; A lens or other part of an optical instrument that interacts with light.; A measuring device with a small window, attached to an upside-down bottle, used to dispense alcoholic drinks in a bar.
optics: (n) The physics of light and vision.; The light-related aspects of a device.; Perception, image, public relations.(n) plural of optic
optime: (n) A student who graduates with second class ("senior optime") or third class ("junior optime") honours in mathematics, or (loosely) in any other subject.
option: (n) One of a set of choices that can be made.; The freedom or right to choose.; A contract giving the holder the right to buy or sell an asset at a set strike price; can apply to financial market transactions, or to ordinary transactions for tangible assets such as a residence or automobile.(v) To purchase an option on something.; To configure, by setting an option.
opus: (n) A work of music or set of works with a specified rank in an ordering of a composer's complete published works.; A work, especially of art.
or: (c) Connects at least two alternative words, phrases, clauses, sentences, etc. each of which could make a passage true. In English, this is the "inclusive or." The "exclusive or" is formed by "either[…]or".; An operator denoting the disjunction of two propositions or truth values. There are two forms, the inclusive or and the exclusive or.; Counts the elements before and after as two possibilities.; Otherwise (a consequence of the condition that the previous is false).; Connects two equivalent names.(n) Alternative form of OR(n) The gold or yellow tincture on a coat of arms.(aj) Of gold or yellow tincture on a coat of arms.(av) Early (on).; Earlier, previously.(p) Before; ere. Followed by "ever" or "ere".
OR: (c) Inclusive or; either one proposition or the other is true or both.; A lexical symbol to implement inclusive or in a computer language.; A logical gate to implement inclusive or.(n) The binary operator inclusive or, true if one at least one of two inputs is true. In infix notation.(N) Oregon, a state of the United States of America.; Orissa, a state of India.
Or: (N) A surname.
ora: (n) plural of os; mouths or openings, especially of the cervix.(n) A unit of money among the Anglo-Saxons.
Ora: (N) A female given name from Latin. Mainly used in the U.S.A. in the latter half of the 19th century.
oracle: (n) A shrine dedicated to some prophetic deity.; A person such as a priest through whom the deity is supposed to respond with prophecy or advice.; A prophetic response, often enigmatic or allegorical, so given.; Something said that must come true or cannot be countermanded; an inexorable command or declaration.; A person considered to be a source of wisdom.; A wise sentence or decision of great authority.; A fortune-teller.; One who communicates a divine command; an angel; a prophet.; The sanctuary, or most holy place in the temple; also, the temple itself.; A theoretical entity capable of answering some collection of questions.; A third-party service that provides smart contracts with information from the outside world.(v) To utter oracles or prophecies.
Oracle: (N) A database management system (and its associated software) developed by the Oracle Corporation
oral: (aj) Relating to the mouth.; Done or taken by the mouth.; Relating to the mouth.; Pronounced by the voice resonating in the mouth, as the vowels in English.; Relating to the mouth.; Relating to or denoting a stage of infantile psychosexual development during which libidinal gratification is derived from intake (as of food), by sucking, and later by biting.; Relating to the mouth.; Of, relating to, or characterized by personality traits of passive dependency and aggressiveness.; Spoken rather than written.; Relating to the transmission of information or literature by word of mouth.; Spoken rather than written.; Using speech or the lips especially in teaching the deaf.; Spoken rather than written.; Not having reached the stage of literacy.(n) A spoken test or examination, particularly in a language class.; A physical examination of the mouth.; Ellipsis of oral sex.; Ellipsis of oral steroid.
Oral: (N) A male given name from Latin of American usage(N) A city in Kazakhstan
orally: (av) By mouth.; Spoken as opposed to written.
Oran: (N) A port in Algeria.(N) A male given name from Irish.
orang: (n) An orangutan.
orange: (n) An evergreen tree of the genus Citrus such as Citrus sinensis.; The fruit of the orange tree; a citrus fruit with a slightly sour flavour.; The colour of a ripe fruit of an orange tree, midway between red and yellow.; Various drinks:; Orange juice.; Various drinks:; An orange-coloured and orange-flavoured cordial.; Various drinks:; An orange-coloured and orange-flavoured soft drink.(aj) Having the colour of the fruit of an orange tree; yellowred; reddish-yellow.(v) To color orange.; To become orange.
Orange: (N) A city in the Vaucluse department, Provence-Alpes-Côte d'Azur, France.; The Orange River (the longest river in South Africa); A city in New South Wales; named for William II of the Netherlands, Prince of Orange from 1815 to 1840.; A city in Orange County, California; named for the fruit.; A city in New Jersey; named for William III of England, Prince of Orange from 1650 to 1702.; A city, the county seat of Orange County, Texas.; A town in Connecticut; named for William III of England.; A town in Massachusetts; named for William III of England.; A town, the county seat of Orange County, Virginia.; A village in Cuyahoga County, Ohio.; A town in New York.; A town in Vermont.; A town in Wisconsin.; A town in New Hampshire; named for the orange ochre found in the area.; An unincorporated community in Georgia, United States.; An unincorporated community in Illinois.; An unincorporated community in Indiana; named for its township, itself named for Orange County, North Carolina.; An unincorporated community in Missouri.; An unincorporated community in Coshocton County, Ohio.; An unincorporated community in Delaware County, Ohio.; Prince or Princess of Orange. Title of the first-born to the Dutch Royal House.; a Loyalist or a member of the Orange Order; someone, usually a Protestant, who advocates keeping Northern Ireland under British control.(aj) Relating to the Orange Order.
orangy: (aj) Alternative spelling of orangey
orate: (v) To speak formally; to give a speech.; To speak passionately; to preach for or against something.(aj) Competent in oracy; having good speaking skills.
orator: (n) Someone who orates or delivers an oration.; A skilled and eloquent public speaker.; Someone sent to speak for someone else; an envoy, a messenger.; A petitioner, a supplicant.
orb: (n) A spherical body; a sphere, especially one of the celestial spheres; a sun, planet, or star; One of the azure transparent spheres conceived by the ancients to be enclosed one within another, and to carry the heavenly bodies in their revolutions; A structural motif or finial in the shape of a sphere; An orbit of an heavenly body; The time period of an orbit; The eye, seen as a luminous and spherical entity; Any revolving circular body, such as a wheel; A sphere of action.; A globus cruciger; a ceremonial sphere used to represent royal or imperial power; A translucent sphere appearing in flash photography (Orb (optics)); A body of soldiers drawn up in a circle, as for defence, especially infantry to repel cavalry.(v) To form into an orb or circle.; To become round like an orb.; To encircle; to surround; to enclose.(n) A blank window or panel.
orbit: (n) A circular or elliptical path of a celestial object or spacecraft around a star, planet, moon, or Lagrange point, especially a periodic elliptical revolution.; One complete circuit round an orbited body.; A circular or elliptical path of a celestial object or spacecraft around a star, planet, moon, or Lagrange point, especially a periodic elliptical revolution.; The state of moving in an orbit.; A circular or elliptical path of a celestial object or spacecraft around a star, planet, moon, or Lagrange point, especially a periodic elliptical revolution.; The path of an electron around an atomic nucleus.; A circular or elliptical path of a celestial object or spacecraft around a star, planet, moon, or Lagrange point, especially a periodic elliptical revolution.; A path for the ball on the outer edge of the playfield, usually connected so that the ball entering in one end will come out of the other.; A sphere of influence; an area or extent of activity, interest, or control.; The bony cavity in the skull of a vertebrate containing the eyeball.; The area around the eye of a bird or other animal.; A collection of points related by the evolution function of a dynamical system.; The subset of elements of a set X to which a given element can be moved by members of a specified group of transformations that act on X.; A state of increased excitement, activity, or anger.(v) To circle or revolve around another object or position.; To place an object (e.g. a satellite) into an orbit around a planet.; To move around the general vicinity of something.; To move in a circle.; To center (around).; To continue to follow and/or engage with someone via social media after breaking up with them.
orbits: (n) plural of orbit(v) Third-person singular simple present indicative form of orbit
orbs: (n) plural of orb
orcein: (n) a dye, related to litmus, that is extracted from the lichen Rocella tinctoria; used as a microscopic stain and as a food colouring
orchid: (n) A plant of the orchid family (Orchidaceae), bearing unusually-shaped flowers of beautiful colours.; A light bluish-red, violet-red or purple colour.(aj) having a light purple colour.
ord: (n) A point.; A point of origin; a beginning.; A point of land; a promontory.; The point or edge of a weapon.
Ord: (N) A city, the county seat of Valley County, Nebraska, United States.; A civil parish and village in Northumberland, England; A river in Western Australia
ordain: (v) To prearrange unalterably.; To decree.; To admit into the ministry, for example as a priest, bishop, minister or Buddhist monk, or to authorize as a rabbi.; To predestine.
ordeal: (n) A painful or trying experience.; A trial in which the accused was subjected to a dangerous test (such as ducking in water), divine authority deciding the guilt of the accused.; The poisonous ordeal bean or Calabar bean
order: (n) Arrangement, disposition, or sequence.; A position in an arrangement, disposition, or sequence.; The state of being well arranged.; Conformity with law or decorum; freedom from disturbance; general tranquillity; public quiet.; A command.; A request for some product or service; a commission to purchase, sell, or supply goods.; A group of religious adherents, especially monks or nuns, set apart within their religion by adherence to a particular rule or set of principles.; An association of knights.; Any group of people with common interests.; A decoration, awarded by a government, a dynastic house, or a religious body to an individual, usually for distinguished service to a nation or to humanity.; A category in the classification of organisms, ranking below class and above family; a taxon at that rank.; A number of things or persons arranged in a fixed or suitable place, or relative position; a rank; a row; a grade; especially, a rank or class in society; a distinct character, kind, or sort.; An ecclesiastical rank or position, usually for the sake of ministry, (especially, when plural) holy orders.; The disposition of a column and its component parts, and of the entablature resting upon it, in classical architecture; hence (since the column and entablature are the characteristic features of classical architecture) a style or manner of architectural design.; The sequence in which a side’s batsmen bat; the batting order.; A power of polynomial function in an electronic circuit’s block, such as a filter, an amplifier, etc.; The overall power of the rate law of a chemical reaction, expressed as a polynomial function of concentrations of reactants and products.; The cardinality, or number of elements in a set, group, or other structure regardable as a set.; For given group G and element g ∈ G, the smallest positive natural number n, if it exists, such that (using multiplicative notation), gⁿ = e, where e is the identity element of G; if no such number exists, the element is said to be of infinite order (or sometimes zero order).; The number of vertices in a graph.; A partially ordered set.; The relation on a partially ordered set that determines that it is, in fact, a partially ordered set.; The sum of the exponents on the variables in a monomial, or the highest such among all monomials in a polynomial.; A written direction to furnish someone with money or property; compare money order, postal order.(v) To set in some sort of order.; To arrange, set in proper order.; To issue a command to.; To request some product or service; to secure by placing an order.; To admit to holy orders; to ordain; to receive into the ranks of the ministry.
Order: (N) The Order of the Arrow.
orders: (n) plural of order(v) Third-person singular simple present indicative form of order
ordure: (n) Dung, excrement.; Dirt, filth.; Something regarded as contaminating or perverting the morals; obscene material.
ore: (n) Rock or other material that contains valuable or utilitarian materials; primarily a rock containing metals or gems for which it is typically mined and processed.
Ore: (N) A village in East Sussex, England.
oread: (n) A mountain nymph; an anthropomorphic appearance of the spirit of a mountain.
Oregon: (N) A state in the Pacific Northwest region of the United States. Capital: Salem. Largest city: Portland.; Several other locations in the United States:; A city in Lucas County, Ohio.; Several other locations in the United States:; A small city, the county seat of Ogle County, Illinois.; Several other locations in the United States:; A small city, the county seat of Holt County, Missouri.; Several other locations in the United States:; A town and village in Dane County, Wisconsin.; Several other locations in the United States:; An unincorporated community in Mercer County, Kentucky.; Several other locations in the United States:; An unincorporated community in Baltimore County, Maryland.; Several other locations in the United States:; An unincorporated community in Lancaster County, Pennsylvania.; Several other locations in the United States:; A ghost town in Boone County, Arkansas.; Several other locations in the United States:; A ghost town in Wilson County, Tennessee.; A community in Victoria County, Nova Scotia, Canada.; University of Oregon.
ores: (n) plural of ore
organ: (n) The larger part of an organism, composed of tissues that perform similar functions.; A body of an organization dedicated to the performing of certain functions.; A musical instrument that has multiple pipes which play when a key is pressed (the pipe organ), or an electronic instrument designed to replicate such.; An official magazine, newsletter, or similar publication of an organization.; Short for organ pipe cactus.; government organization; agency; authority; The penis.(v) To supply with an organ or organs; to fit with organs.
Organ: (N) A surname.; A census-designated place in Doña Ana County, New Mexico, United States.
organs: (n) plural of organ(v) Third-person singular simple present indicative form of organ
Organs: (N) plural of Organ
orgasm: (n) A spasm or sudden contraction.; A rush of sexual excitement; now specifically, the climax or peak of sexual pleasure, which occurs during sexual activity and which in males may include ejaculation and in females vaginal contractions.; A creamy white alcoholic cocktail containing amaretto, Irish cream, and coffee liqueur.(v) To have an orgasm.
orgeat: (n) A sweet syrup made from sugar and almonds (or originally barley) and rose water or orange flower water.
orgies: (n) plural of orgy; plural of orgie
orgy: (n) Originally, secret rites or ceremonies, typically involving riotous and dissolute behaviour, including dancing, drunkenness and indiscriminate sexual activity, undertaken in honour of various pagan gods or goddesses (such as Attis, Bacchus, Ceres, Dionysus, Osiris, etc).; A gathering of people to engage in group sex.; Excessive indulgence in a specified activity.
oriel: (n) A large polygonal recess in a building, such as a bay window, forming a protrusion on the outer wall.; A small apartment next to a hall, used for dining.
Oriel: (N) Ellipsis of Oriel College, Oxford.
orient: (N) Usually preceded by the: alternative letter-case form of Orient (“a region or a part of the world to the east of a certain place; countries of Asia, the East (especially East Asia)”)(n) The part of the horizon where the sun first appears in the morning; the east.; A pearl originating from the Indian region, reputed to be of great brilliance; (by extension) any pearl of particular beauty and value.; The brilliance or colour of a high-quality pearl.(aj) Rising, like the morning sun.; Of the colour of the sky at daybreak; bright in colour, from red to yellow.; Of, facing, or located in the east; eastern, oriental.; Of a pearl or other gem: of great brilliance and value; (by extension) bright, lustrous.(v) To build or place (something) so as to face eastward.; To align or place (a person or object) so that his, her, or its east side, north side, etc., is positioned toward the corresponding points of the compass; (specifically, surveying) to rotate (a map attached to a plane table) until the line of direction between any two of its points is parallel to the corresponding direction in nature.; To direct towards or point at a particular direction.; To determine which direction one is facing.; To familiarize (oneself or someone) with a circumstance or situation.; To set the focus of (something) so as to appeal or relate to a certain group.; To change direction to face a certain way.
Orient: (N) Usually preceded by the: a region or a part of the world to the east of a certain place; countries of Asia, the East (especially East Asia).; The countries east of the Mediterranean.(N) A city and town in Illinois.; A city and town in Iowa.; A town in Maine.; A census-designated place and hamlet in New York.; A town and village in South Dakota.(n) A pear cultivar from the United States
origan: (n) Alternative form of oregano (“wild marjoram, Origanum vulgare”)
origans: (n) plural of origan
origin: (n) The beginning of something.; The source of a river, information, goods, etc.; The point at which the axes of a coordinate system intersect.; The proximal end of attachment of a muscle to a bone that will not be moved by the action of that muscle.; An arbitrary point on Earth's surface, chosen as the zero for a system of coordinates.; Ancestry.
oriole: (n) Any of various colourful passerine birds, the New World orioles from the family Icteridae and the Old World orioles from the family Oriolidae.
Oriole: (n) A player on the team Baltimore Orioles.
Orion: (N) A giant-hunter, pursuer of the Pleiades and lover of Eos, and killed by Artemis.; A constellation on the celestial equator close to Gemini and Taurus, containing the stars Betelgeuse and Rigel.; A surname.; A male given name from Ancient Greek of modern usage.; A female given name.; Place names:; A locality in the Central Highlands Region, Queensland, Australia.; Place names:; A hamlet in the Municipal District of County of Forty Mile No. 8, Alberta, Canada.; Place names:; A commune of the Pyrenées-Atlantiques department, France.; Place names:; A municipality of Bataan, Philippines.; Place names:; An unincorporated community in Pike County, Alabama, United States, also known as Prospect Ridge.; Place names:; A ghost town in Kings County, California, United States.; Place names:; A village in Henry County, Illinois, United States.; Place names:; A town in Richland County, Wisconsin, United States.
orison: (n) A prayer.; Mystical contemplation or communion.
Orissa: (N) Former name of Odisha.
Oriya: (N) Odia, the language spoken in the state of Odisha, India.(n) An inhabitant of Odisha.
orle: (n) a bordure that runs around the outline of a shield without touching the edge; the wreath, or chaplet, surmounting or encircling the helmet of a knight and bearing the crest; a torse; a fillet under the ovolo of a capital
Orle: (N) A municipality of Croatia.
Orlon: (n) a synthetic fibre used in yarn and knitwear
Orlons: (n) plural Orlon
orlop: (n) The platform over the hold of a ship that makes up the fourth or lowest deck, hence in full called orlop deck, especially of a warship.
Orly: (N) A city and commune of the department of the Val-de-Marne, region of Île-de-France, France.; Paris-Orly Airport.
Ormazd: (N) Alternative form of Ahura Mazda
ormolu: (n) Golden or gilded brass or bronze used for decorative purposes.(aj) Made from golden or gilded brass or bronze.(v) To decorate with gilded ormolu articles.
ornate: (aj) Elaborately ornamented, often to excess.; Flashy, flowery or showy; Finely finished, as a style of composition.(v) To adorn; to honour.
ornater: (adj) plural of ornate
ornery: (aj) Cantankerous, stubborn, disagreeable.; Mischievous, prankish, teasing, disagreeable but in a good way.; Commonplace, inferior.
ornis: (n) A bird.; The birds collectively of a region; avifauna.
ornises: (n) plural of ornis
orphan: (n) A person, especially a minor, both or (rarely) one of whose parents have died.; A person, especially a minor, whose parents have permanently abandoned them.; A young animal with no mother.; Anything that is unsupported, as by its source, provider or caretaker, by reason of the supporter's demise or decision to abandon.; A single line of type, beginning a paragraph, at the bottom of a column or page.; Any unreferenced object.(aj) Deprived of parents (also orphaned).; Remaining after the removal of some form of support.(v) To deprive of parents (used almost exclusively in the passive); To make unavailable, as by removing the last remaining pointer or reference to.
orpine: (n) Any of several temperate succulent plants of the family Crassulaceae, that have clusters of purple flowers, especially Hylotelephium telephium.; A yellow pigment of various degrees of intensity, sometimes approaching red.
orrery: (n) A clockwork model of any given solar system.
orris: (n) Any of several irises that have a fragrant root, especially Iris × germanica.; The fragrant root of such an iris.(n) A type of gold or silver lace.; A pattern in which gold lace or silver lace is worked, especially one in which the edges are ornamented with conical figures placed at equal distances, with spots between them.
Orris: (N) A surname, from given names.
ort: (n) A fragment; a scrap of leftover food; any remainder; a piece of refuse.(v) To turn away from with disgust; refuse.
orts: (n) plural of ort
Orwell: (N) An English surname.; A village in Cambridgeshire, England; A river in Suffolk, England; A town in New York; A village in Ohio; A settlement in Prince Edward Island; A town in Vermont
oryx: (n) Any of several antelopes, of the genus Oryx, native to Africa, which have long, straight horns
os: (n) Synonym of bone.(n) An opening or entrance to a passage, particularly one at either end of the cervix, internal (to the uterus) or external (to the vagina).(n) An osar or esker.(n) Alternative form of o's.
OS: (n) an Ordnance Survey map.; The left eye (initialism of Latin oculus sinister).
Os: (n) plural of O
Osage: (n) An indigenous North American people.; A member of the Osage tribe.(N) The language of this people.; A village in Saskatchewan, Canada.; An unincorporated community in Carroll County, Arkansas.; A city, the county seat of Mitchell County, Iowa, United States.; A census-designated place and unincorporated community in Becker County, Minnesota.; An unincorporated community in Camden County, New Jersey.; An unincorporated community in Jefferson County, Ohio.; A small town in Osage County, Oklahoma.; An unincorporated community in Monongalia County, West Virginia.; A census-designated place in Wyoming.; A river in Missouri (the Osage River), which is a tributary of the Missouri River.
Oscan: (aj) Of or pertaining to the Oscan language or Oscan people, or their writing system.(n) A member of an ancient group of Italic-speaking peoples of Campania (the Osci).(N) The extinct language of the Oscan people.
oscar: (n) Astronotus ocellatus, a cichlid fish, native to South America, sometimes kept in aquariums.
Oscar: (N) A male given name from Irish or Old English.; An Irish patronymic surname, from Irish, a rare anglicization of Mac Oscair (“son of Oscar”) (McCusker).; The letter O in the ICAO spelling alphabet.; A locale in the United States.; An unincorporated community in Kentucky; named for Kentucky Representative Oscar Turner.; A locale in the United States.; An unincorporated community in Louisiana.; A locale in the United States.; An unincorporated community in Missouri; named for early settler Oscar Bradford.; A locale in the United States.; An unincorporated community in Oklahoma; named for local rancher Oscar W. Seay.; A locale in the United States.; An unincorporated community in Pennsylvania.; A locale in the United States.; An unincorporated community in West Virginia.(n) An Academy Award.; A statuette awarded by the Academy of Motion Picture Arts and Sciences.(n) cash; money.
oscine: (aj) Of or pertaining to the songbirds (suborder Passeri).(n) Any bird of the suborder Passeri (the songbirds), which have better vocal control than other birds.
osier: (n) A kind of willow, Salix viminalis, growing in wet places in Europe and Asia, and introduced into North America. It is considered the best of the willows for wickerwork (basketweaving with wicker). The name is sometimes given to any kind of willow.; One of the long, pliable twigs of this plant, or of other similar plants.
Osier: (N) A surname, from French.
osiers: (n) plural of osier
Osiers: (N) plural of Osier
Osiris: (N) The Egyptian god of the dead and of the underworld.; An exoplanet in the Pegasus constellation, HD 209458 b.
Oslo: (N) A county and municipality, the capital city of Norway. Formerly called Christiania and Kristiania.; A tiny city in Marshall County, in northwest Minnesota, United States.; An unincorporated community in Vernon Township, Dodge County, Minnesota, United States.; An unincorporated community in Indian River County, Florida, United States.
osmic: (aj) Pertaining to, derived from, or containing, osmium; specifically, designating those compounds in which it has a higher valence.; Relating to the sense of smell
osmium: (n) A chemical element (symbol Os) with atomic number 76: a hard, brittle, heavy, bluish-white transition metal found as a trace element in alloys, mostly in platinum ores.; A single atom of this element.
osmose: (v) To diffuse by osmosis.; To cause to diffuse by osmosis.(n) Archaic form of osmosis.
osprey: (n) A bird of prey (Pandion haliaetus) that feeds on fish and has white underparts and long, narrow wings each ending in four finger-like extensions.; aigrette (ornamental feather)
ossa: (n) plural of os
Ossa: (N) A surname.; A village in Larissa regional unit, Greece.; A village in Thessaloniki regional unit, Greece.
ossein: (n) The collagen component of bone
Ossian: (N) A male given name from Irish; rather rare in the Anglo-Saxon world.
ossify: (v) To transform (or cause to transform) from a softer animal substance into bone; particularly the processes of growth in humans and animals.; To become (or cause to become) inflexible and rigid in habits or opinions.; To grow (or cause to grow) formulaic and permanent.; To calcify.
osteal: (aj) bony
ostend: (v) To exhibit; to manifest.
Ostend: (N) The largest coastal city of Belgium.
ostia: (n) plural of ostium
Ostia: (N) A port and town on the Tiber in Italia, Roman Empire, the harbour of ancient Rome; A modern refounding of the ancient town at the mouth of the Tiber, now a neighbourhood of Rome, Italy
ostium: (n) A small opening or orifice, as in a body organ or passage.; Any of the small openings or pores in a sponge.; The mouth of a river.
ostler: (n) A person employed at an inn, hostelry, or stable to look after horses; a groom
Ostyak: (n) A member of any of several indigenous peoples in Siberia, Russia, including the Khanty people and the Ket people.(N) Any of various languages of these peoples.
other: (aj) See other (determiner) below.; Second.; Alien.; Different.; Left, as opposed to right.(n) An other, another (person, etc), more often rendered as another.; The other one; the second of two.(d) Not the one or ones previously referred to.(av) Otherwise.(v) To regard, label, or treat as an "other", as not part of the same group; to view as different and alien.; To treat as different or separate; segregate; ostracise.
others: (n) plural of other(n) Other people.; Those remaining after one or more people or items have left, or done something else, or been excluded.(v) Third-person singular simple present indicative form of other
otic: (aj) Of, relating/pertaining to, or located near the ear.
otiose: (aj) Having no effect.; Done in a careless or perfunctory manner.; Reluctant to work or to exert oneself.; Of a person, possessing a bored indolence.; Having no reason for being (raison d’être); having no point, reason, or purpose.
otitis: (n) Inflammation of the ear.
ottar: (n) Alternative form of attar
ottava: (av) One octave higher; as a marking, typically abbreviated 8va.(n) Ottava rima.
otter: (n) An aquatic or marine carnivorous mammal in the subfamily Lutrinae of the family Mustelidae, which also includes weasels, polecats, badgers, and others.; A hairy man with a slender physique, in contrast with a bear, who is more thickset.(n) annatto (dye)(n) Archaic form of attar.
Otter: (N) A river with its source in the Blackdown Hills, Somerset, and which flows through Devon, to Lyme Bay in the English Channel.
ottered: (v) plural of otter
ottering: (v) plural of otter
otters: (n) plural of otter
otto: (n) Alternative form of attar
Otto: (N) A male given name from the Germanic languages.; Places in the United States of America:; An unincorporated community in Clark County, Indiana.; Places in the United States of America:; A town in Cattaraugus County, New York.; Places in the United States of America:; An unincorporated community in Macon County, North Carolina.; Places in the United States of America:; An unincorporated community in Roane County, West Virginia.; Places in the United States of America:; An unincorporated community in Big Horn County, Wyoming.
ou: (n) A probably extinct species of Hawaiian honeycreeper, Psittirostra psittacea.(n) A fellow, guy, bloke.
ouch: (i) An expression of one's own physical pain.; An expression in sympathy at another's pain.; A reply to an insult seen as savage (frequently one that is tongue-in-cheek or joking).; An expression of disappointment.; Expressing surprise at the high price of something.(n) Alternative form of ouche
Ouch: (N) A surname.
ouched: (v) plural of ouch
ouching: (v) plural of ouch
oud: (n) A short-necked and fretless plucked stringed instrument of the lute family, of Arab and Turkish origin.; Agarwood.
ought: (v) simple past tense of owe(v) Indicating duty or obligation.; Indicating advisability or prudence.; Indicating desirability.; Indicating likelihood or probability.(P) Alternative spelling of aught; anything(av) Alternative spelling of aught; at all, to any degree.(n) A statement of what ought to be the case as contrasted with what is the case.(n) Alternative spelling of aught; cipher, zero, nought.
oughted: (v) plural of ought
oughting: (v) plural of ought
oui: (i) Synonym of yes
ouija: (n) Alternative form of Ouija
Ouija: (n) A board, having letters of the alphabet and the words yes and no; used with a planchette during a seance to "communicate" with spirits.; The use of such a board to attempt to communicate with spirits.
Oujda: (N) A city, the capital of the Oriental Region, Morocco.
ounce: (n) An avoirdupois ounce, weighing ¹⁄₁₆ of an avoirdupois pound, or 28.3495 grams.; A troy ounce, weighing ¹⁄₁₂ of a troy pound, or 480 grains, or 31.1035 grams.; A US fluid ounce, with a volume of ¹⁄₁₆ of a US pint, 1.8047 cubic inches or 29.5735 millilitres.; A British imperial fluid ounce, with a volume of ¹⁄₂₀ of an imperial pint, 1.7339 cubic inches or 28.4131 millilitres.; A little bit.(n) A large wild feline, such as a lynx or cougar.; Now specifically, the snow leopard, Panthera uncia.
ounces: (n) plural of ounce
ouphe: (n) A small, often mischievous sprite; a fairy; a goblin; an elf.
our: (d) Belonging to us.; Of, from, or belonging to the nation, region, or language of the speaker.; Used before a person's name to indicate that the person is in one's family, or is a very close friend.(v) Misspelling of are.
ours: (P) That which belongs to us; the possessive case of we, used without a following noun.
ous: (n) plural of ou
ouse: (v) Dated form of ooze.
Ouse: (N) Various rivers in England.; River Ouse, Yorkshire.; Various rivers in England.; River Ouse, Sussex: A river in both West Sussex and East Sussex.; Various rivers in England.; River Great Ouse, Northamptonshire and East Anglia.; Various rivers in England.; River Little Ouse, a tributary of the River Great Ouse.
ousel: (n) Alternative form of ouzel
oust: (v) To expel; to remove.
ousted: (v) simple past tense and past participle of oust
ouster: (n) A putting out of possession; dispossession; ejection.; Action by a cotenant that prevents another cotenant from enjoying the use of jointly owned property.; Specifically, the forceful removal of a politician or regime from power; coup.(v) To oust.(n) Someone who ousts.
out: (av) Away from the inside, centre or other point of reference.; Away from home or one's usual place.; Outside; not indoors.; Away from; at a distance.; Into a state of non-operation or non-existence.; To the end; completely.; Used to intensify or emphasize.; So as to be visible in the sky, and not covered by clouds, fog, etc.; Of a player, so as to be disqualified from playing further by some action of a member of the opposing team (such as being stumped in cricket).(p) From from the inside to the outside of; out of.(n) A means of exit, escape, reprieve, etc.; A state in which a member of the batting team is removed from play due to the application of various rules of the game such as striking out, hitting a fly ball which is caught by the fielding team before bouncing, etc.; A dismissal; a state in which a member of the batting team finishes his turn at bat, due to the application of various rules of the game, such as the bowler knocking over the batsman's wicket with the ball.; A card which can make a hand a winner.; A trip out; an outing.; One who, or that which, is out; especially, one who is out of office.; A place or space outside of something; a nook or corner; an angle projecting outward; an open space.; A word or words omitted by the compositor in setting up copy; an omission.(v) To eject; to expel.; To come or go out; to get out or away; to become public, revealed, or apparent.; To reveal (a person or organization) as having a certain secret, such as a being a secret agent or undercover detective.; To reveal (a secret).; To reveal (a person) as LGBT+ (gay, trans, etc).; To kill; to snuff out.(aj) Not inside a place one might otherwise be expected to be, especially a place one was formerly or is customarily inside:; Not at home, or not at one's office or place of employment.; Not inside a place one might otherwise be expected to be, especially a place one was formerly or is customarily inside:; Not in jail, prison, or captivity; freed from confinement; Not inside a place one might otherwise be expected to be, especially a place one was formerly or is customarily inside:; Not inside or within something.; Not inside a place one might otherwise be expected to be, especially a place one was formerly or is customarily inside:; Not fitted or inserted into something.; Not inside a place one might otherwise be expected to be, especially a place one was formerly or is customarily inside:; Of the ball or other playing implement, falling or passing or being situated outside the bounds of the playing area.; Not (or no longer) acceptable or in consideration, play, availability, or operation:; Dismissed from play under the rules of the game.; Not (or no longer) acceptable or in consideration, play, availability, or operation:; Discarded; no longer a possibility.; Not (or no longer) acceptable or in consideration, play, availability, or operation:; acceptable, permissible; Not (or no longer) acceptable or in consideration, play, availability, or operation:; Not available; out of service.; Not (or no longer) acceptable or in consideration, play, availability, or operation:; Not having availability of a service, such as power or communications.; Not (or no longer) acceptable or in consideration, play, availability, or operation:; Not shining or burning.; Not (or no longer) acceptable or in consideration, play, availability, or operation:; Temporarily not in operation, or not being attended as usual.; Not (or no longer) acceptable or in consideration, play, availability, or operation:; No longer popular or in fashion.; Open or public (about something).; Openly acknowledging that one is LGBT+ (gay, trans, etc).; Open or public (about something).; Open, public; public about or openly acknowledging some (usually specified) identity.; Freed from from secrecy.; Available to be seen, or to be interacted with in some way:; Released, available for purchase, download or other use.; Available to be seen, or to be interacted with in some way:; In bloom.; Available to be seen, or to be interacted with in some way:; Visible in the sky; not obscured by clouds.; Available to be seen, or to be interacted with in some way:; Of a young lady: having entered society and available to be courted.; Of the tide, at or near its lowest level.; Without; no longer in possession of; not having more; Containing errors or discrepancies; in error by a stated amount.(i) A radio procedure word meaning that the station is finished with its transmission and does not expect a response.; Get out; begone; away!
outage: (n) A temporary suspension of operation, especially of electrical power supply.; The amount of something lost in storage or transportation.
outbid: (v) To bid more than (somebody else) in an auction.
outcry: (n) A loud cry or uproar.; A strong protest.; An auction.(v) To cry out.; To cry louder than.
outdid: (v) simple past tense of outdo
outdo: (v) To excel; go beyond in performance; surpass.
outer: (aj) Outside; external.; Farther from the centre of the inside.(n) An outer part.; An uncovered section of the seating at a stadium or sportsground.; The 4th circle on a target, outside the inner and magpie.; A shot which strikes the outer of a target.; The smallest single unit sold by wholesalers to retailers, usually one retail display box.(n) Someone who admits to something publicly.; Someone who outs another.; One who puts out, ousts, or expels.; An ouster; dispossession.; One who supports leaving the European Union.
outfit: (n) A set of clothing (with accessories).; Gear consisting of a set of articles or tools for a specified purpose.; Any cohesive group of people; a unit; such as a military company.; A business or firm.; A sports team.; An outlier-sensitive fit.; A fiscal year of the Hudson's Bay Company, or the supplies required for such a period.(v) To provide with, usually for a specific purpose.
outfox: (v) to beat in a competition of wits
outgo: (v) To go out, to set forth.; To go further; to exceed or surpass; go beyond.; To overtake; to travel faster than.; To outdo; exceed; surpass.; To come to an end.(n) The act or process of going out.; A quantity of a substance or thing that has flowed out; an outflow.; an expenditure, cost or outlay.
outing: (n) A pleasure trip or excursion.; An appearance to perform in public, for example in a drama, film, on a musical album, as a sports contestant etc.; The practice of publicly revealing that a person is homosexual or transgender without that person's consent.(v) present participle of out
outlaw: (n) A fugitive from the law.; A criminal who is excluded from normal legal rights; one who can be killed at will without legal penalty.; A person who operates outside established norms.; A wild horse.; An in-law: a relative by marriage.; One who would be an in-law except that the marriage-like relationship is unofficial.; A prostitute who works alone, without a pimp.(v) To declare illegal.; To place a ban upon.; To remove from legal jurisdiction or enforcement.; To deprive of legal force.
Outlaw: (N) A surname, from nicknames.
outlay: (n) A laying out or expending; that which is laid out or expended.; The spending of money, or an expenditure.; A remote haunt or habitation.(v) To lay or spread out; expose; display.; To spend, or distribute money.
outlet: (n) A vent or similar passage to allow the escape of something.; Something which allows for the release of one's desires.; A river that runs out of a lake.; A shop that sells the products of a particular manufacturer or supplier.; A wall-mounted device such as a socket or receptacle connected to an electrical system at which current is taken to supply utilization equipment or appliances.
outman: (v) To have more people than (one's competitor); to outnumber in men.; To outdo in manliness.
Outman: (N) A surname.
output: (n) Production; quantity produced, created, or completed.; Data sent out of the computer, as to output device such as a monitor or printer, or data sent from one program on the computer to another.; The flow rate of body liquids such as blood and urine.(v) To produce, create, or complete.; To send data out of a computer, as to an output device such as a monitor or printer, or to send data from one program on the computer to another.
outran: (v) simple past tense of outrun
outrun: (v) To run faster than.; To exceed or overextend.(n) In ski jumping, the flat or uphill area past the landing point, where the skier can slow down.; The sheepdog's initial run towards the sheep, done in a curving motion so as not to startle them.
outs: (n) plural of out(v) Third-person singular simple present indicative form of out
outset: (n) Onset; the beginning or initial stage of something.(v) To cause (a design element) to extend around the outside of something else, the opposite of being inset.
outwit: (v) To get the better of; to outsmart, to beat in a competition of wits.
ouvert: (n) A position in which the feet are apart, or a movement which brings them apart.; An open-crotch undergarment.
ouzel: (n) The Eurasian blackbird, Turdus merula.; The water ouzel, an aquatic perching bird, Cinclus mexicanus.
ouzo: (n) An anise-flavoured aperitif, originating in Greece.; A serving of this drink.
ova: (n) plural of ovum(p) Pronunciation spelling of over.
OVA: (n) Original video animation, a direct-to-video anime.
oval: (n) An elongated round shape resembling an egg or ellipse.; A thing having such a shape, such as an arena.; In a projective plane, a set of points such that no three are collinear and there is a unique tangent line at each point.; A sports field, typically but not exclusively oval in shape.(aj) Having the shape of an oval.; Of or pertaining to an ovum.
Oval: (N) A cricket ground in South London.; Short for Oval Office.
ovals: (n) plural of oval
ovary: (n) A female reproductive organ, often paired, that produces ova and in mammals secretes the hormones estrogen and progesterone.; The lower part of a pistil or carpel that bears ovules and ripens into fruit.
ovate: (aj) Shaped like an egg.; With the broadest extremity near the base.(n) An egg-shaped hand axe.(n) An Irish bard.; A member of the Order of Bards, Ovates and Druids, a neo-druidism order based in England.; A modern-day bard of a gorsedd, especially one acknowledged at an eisteddfod.
ovates: (v) plural of ovate
ovating: (v) plural of ovate
oven: (n) A chamber used for baking or heating.(v) To cook in an oven
ovened: (v) plural of oven
ovening: (v) plural of oven
ovens: (n) plural of oven
over: (aj) Discontinued; ended or concluded.(av) Thoroughly; completely; from beginning to end.; To an excessive degree; overly.; From an upright position to a horizontal one.; Horizontally; left to right or right to left.; From one side of something to another, passing above it.; From one position or state to another.; Overnight (throughout the night).; Again; another time; once more; over again.(n) A set of six legal balls bowled.; Any surplus amount of money, goods delivered, etc.(p) Expressing spatial relationship.; On top of; above; higher than; further up.; Expressing spatial relationship.; Across or spanning.; Expressing spatial relationship.; In such a way as to cover.; Expressing spatial relationship.; From one physical position to another via an obstacle that must be traversed vertically, first upwards and then downwards.; Expressing comparison.; More than; to a greater degree.; Expressing comparison.; Beyond; past; exceeding; too much or too far.; Expressing comparison.; As compared to.; Indicating relative status, authority, or power; Divided by.; Separates the three of a kind from the pair in a full house.; Finished with; done with; from one state to another via a hindrance that must be solved or defeated; or via a third state that represents a significant difference from the first two.; While using, especially while consuming.; Concerning or regarding.; Above, implying superiority after a contest; in spite of; notwithstanding.(i) A radio procedure word meaning that the station is finished with its transmission and is expecting a response.(v) To go over, or jump over.; To run about.(n) A shore, riverbank.
Over: (N) A village and civil parish in South Cambridgeshire district, Cambridgeshire, England (OS grid ref TL3770).; A suburban area in Winsford, Cheshire West and Chester district, Cheshire, England (OS grid ref SJ6366).; A hamlet in Almondsbury parish, South Gloucestershire district, Gloucestershire, England (OS grid ref ST5882); A hamlet near Gloucester in Highnam parish, Tewkesbury district, Gloucestershire (OS grid ref SO8119).; A village in Seevetal, Lower Saxony, Germany.
overdo: (v) To do too much; to exceed what is proper or true in doing; to carry too far.; To cook for too long.; To give (someone or something) too much work; to require too much effort or strength of (someone); to use up too much of (something).; To do more than (someone); to do (something) to a greater extent.
overly: (av) To an excessive degree.; Superficially.; Carelessly, without due attention.; With a sense of superiority, haughtily.(aj) Superficial; not thorough; careless, negligent, inattentive.; Having a sense of superiority, haughty.; Excessive; too great.
overt: (aj) Open and not concealed or secret.
Ovid: (N) A 1st century BC Roman poet.; A male given name from Latin of mainly historic use.; A statutory town in Sedgwick County, Colorado.; An unincorporated community in Bear Lake County, Idaho.; A small city in Clinton County and Shiawassee County, Michigan.; A ghost town in Ray County, Missouri.; A town and village in Seneca County, New York; the village is one of the two county seats of the county.
ovine: (aj) Of, being, pertaining to, or resembling a sheep; also, (not comparable) of an animal: from the genus Ovis.; Resembling a sheep in character; acquiescent, easily influenced, passive, or willing to follow a leader blindly.(n) An animal from the genus Ovis; a sheep.; A person regarded as resembling a sheep in character; one who is acquiescent, easily influenced, passive, or willing to follow a leader blindly; a sheep.
ovoid: (aj) Shaped like an oval.; Egg-shaped; shaped like an oval, but more tapered at one end; ovate.(n) Something that is oval in shape.
ovoli: (n) plural of ovolo
ovolo: (n) A classical convex moulding carved with an egg-and-dart ornament.
ovular: (aj) Of or pertaining to an oval.; Of or pertaining to an ovule.(n) A seminar for feminists.
ovule: (n) The structure in a plant that develops into a seed after fertilization; the megasporangium of a seed plant with its enclosing integuments.; An immature ovum in mammals.
ovum: (n) The female gamete in animals; the egg cell.
ow: (i) Synonym of ouch (“cry of pain”); Used for emotional emphasis.
owe: (v) To be under an obligation to give something back to someone or to perform some action for someone.; To have debt; to be in debt.; To have as a cause; used with to.
owed: (v) simple past tense and past participle of owe(aj) That owes.
Owen: (N) A male given name from Welsh, an anglicization of Welsh Owain.; A male given name from Irish, an anglicization of Irish Eoghan.; A Welsh patronymic surname, from Welsh derived from the given name.; An Irish patronymic surname, from Irish, a variant of McKeown.; An Scottish patronymic surname, from Scottish Gaelic, a variant of MacEwen.; A town in Baden-Württemberg, Germany.; A city in Wisconsin; named for the John S. Owen Company.; A community in South Australia.; An unincorporated community in Indiana; named for county official John Owen.; A ghost town in Missouri; named for local merchant James W. Owen.
Owens: (N) A surname, from given names.
ower: (n) A person who owes something, especially money.(p) over(av) over(aj) overly, too
owes: (v) Third-person singular simple present indicative form of owe
owing: (aj) Still to be paid; owed as a debt.(v) present participle of owe
owl: (n) Any of various birds of prey of the order Strigiformes that are primarily nocturnal and have forward-looking, binocular vision, limited eye movement, and good hearing.; A person seen as having owl-like characteristics, especially appearing wise or serious, or being nocturnally active.; The owl pigeon.; A politician with moderate views that are neither hawkish nor dovish.; Any of various nymphalid butterflies, especially in the genus Caligo, having large eyespots on the wings.(v) To smuggle contraband goods.
owlet: (n) Diminutive of owl; A young owl; owling.; One of a species of small owls, such as Athene noctua.; An owlet moth.
owlish: (aj) Resembling or characteristic of an owl.; Wise and solemn.; Stupid; dull-looking.
owls: (n) plural of owl
own: (aj) Belonging to; possessed; acquired; proper to; property of; titled to. Often marks a possessive determiner as reflexive, referring back to the subject of the clause or sentence.; Not shared; Peculiar, domestic.; Not foreign.(v) To have rightful possession of (property, goods or capital); to have legal title to; to acquire a property or asset.; To have recognized political sovereignty over a place, territory, as distinct from the ordinary connotation of property ownership.; To defeat or embarrass; to overwhelm.; To virtually or figuratively enslave.; To defeat, dominate, or be above, also spelled pwn.; To illicitly obtain superuser or root access to a computer system, thereby having access to all of the user files on that system; pwn.; To be very good.; To admit, concede, grant, allow, acknowledge, confess; not to deny.; To admit; concede; acknowledge.; To take responsibility for.; To answer to.; To recognise; acknowledge.; To claim as one's own.; To confess.
owned: (v) simple past tense and past participle of own
owner: (n) One who owns something.; The captain of a ship.
owners: (n) plural of owner
owning: (v) present participle of own
owns: (v) Third-person singular simple present indicative form of own
owre: (n) Obsolete form of hour.; Obsolete form of oar.; Obsolete form of ore.; Obsolete form of our.
ox: (n) An adult castrated male of cattle (B. taurus), especially when used as a beast of burden.; Any bovine animal (genus Bos). A neat, a beef.
Ox: (N) A Chinese constellation located near Capricorn, one of the 28 lunar mansions and part of the larger Black Turtle.; The second of the 12-year cycle of animals which appear in the Chinese zodiac related to the Chinese calendar.; A surname.; Clipping of Oxford.
oxalic: (aj) Of or pertaining to oxalic acid or its derivatives.; Of or pertaining to oxaluria.
oxalis: (n) Any of various ornamental flowering plants of the genus Oxalis
oxbow: (n) A U-shaped piece of wood used as a collar for an ox, the upper parts fastened to its yoke; A meander in a river; the land enclosed by such a loop
Oxbow: (N) A town in North Dakota.; A town in Saskatchewan, Canada.
oxcart: (n) A cart designed to be drawn by an ox or oxen.
oxen: (n) plural of ox(aj) Of, relating to, or resembling an ox; oxlike
oxford: (n) Alternative letter-case form of Oxford (cloth); Alternative letter-case form of Oxford (shoe)
Oxford: (N) A city in Oxfordshire, England, famous for its university.; Ellipsis of University of Oxford.; An English habitational surname derived from the city in England.; A number of places in the United States:; A city in Alabama.; A number of places in the United States:; A city in Arkansas.; A number of places in the United States:; An unincorporated community in Colorado.; A number of places in the United States:; A town in Connecticut; named for the city in England.; A number of places in the United States:; An unincorporated community in Florida.; A number of places in the United States:; A city in Georgia, United States; named for the university.; A number of places in the United States:; A city in Idaho.; A number of places in the United States:; A town in Indiana.; A number of places in the United States:; A city in Iowa; named for its township, itself named for the town in New York.; A number of places in the United States:; A city in Kansas.; A number of places in the United States:; An unincorporated community in Kentucky.; A number of places in the United States:; A town in Maine; named for the city in England.; A number of places in the United States:; A town in Maryland.; A number of places in the United States:; A town in Massachusetts.; A number of places in the United States:; A village in Michigan.; A number of places in the United States:; A city, the county seat of Lafayette County, Mississippi; named for the city in England.; A number of places in the United States:; A village in Furnas County and Harlan County, Nebraska.; A number of places in the United States:; A census-designated place in New Jersey.; A number of places in the United States:; A town and village in New York; named for the town in Massachusetts.; A number of places in the United States:; A town, the county seat of Granville County, North Carolina.; A number of places in the United States:; A city in Ohio.; A number of places in the United States:; A borough of Pennsylvania.; A number of places in the United States:; An unincorporated community in West Virginia.; A number of places in the United States:; A town and village in Wisconsin.; A neighborhood of Edmonton, Alberta.; A town in Nova Scotia.; A settlement on Saint Croix, in the United States Virgin Islands.; A town in Canterbury, New Zealand.(n) A variety of shoe, typically made of heavy leather.; An Oxford Dictionary.
oxide: (n) A binary chemical compound of oxygen with another chemical element.
oxides: (n) plural of oxide
oxime: (n) Any of a class of organic compounds, of general formula RR'C=NOH, derived from the condensation of an aldehyde (R' = H) or ketone with hydroxylamine.
oxtail: (n) The tail of an ox or cow.; A cut of meat taken from the tail of a cow or calf; it requires long, slow braising, and is used to prepare oxtail soup.
Oxus: (N) The Amu Darya river.
oxygen: (n) The chemical element (symbol O) with an atomic number of 8 and relative atomic mass of 15.9994. It is a colorless and odorless gas.; Molecular oxygen (O₂), a colorless, odorless gas at room temperature, also called dioxygen.; A mixture of oxygen and other gases, administered to a patient to help them breathe.; An atom of this element.; A condition or environment in which something can thrive.
oyer: (n) A hearing in a civil case which is based on the content of a document, in which the plaintiff is required to produce the document.
oyers: (n) plural of oyer
oyez: (i) Hear ye. Attend. (Called by public criers or in court usually three times to secure silence and/or attentiveness).(n) A cry of "oyez".(v) To proclaim with a cry of "oyez".
oyster: (n) Any of certain marine bivalve mollusks, especially those of the family Ostreidae (the true oysters), usually found adhering to rocks or other fixed objects in shallow water along the seacoasts, or in brackish water in the mouth of rivers.; The delicate morsel of dark meat contained in a small cavity of the bone on each side of the lower part of the back of a fowl.; A pale beige color tinted with grey or pink, like that of an oyster.; A person who keeps secrets.; A shoplifter.(aj) Of a pale beige colour tinted with grey or pink, like that of an oyster.(v) To fish for oysters.
Oyster: (N) A surname.
Oz: (N) Ellipsis of Land of Oz, the fictional setting created by Frank L. Baum for The Wonderful Wizard of Oz, and other works. The term has been extended from the original country of Oz to the entire fictional world of Oz. Subsequently used as a setting by other authors and artists.(n) An unreal, magical realm.(N) Australia.(N) Diminutive of Osbourne(N) A surname.(N) A surname, from Turkish.
ozone: (n) An allotrope of oxygen (symbol O₃) having three atoms in the molecule instead of the usual two; it is a toxic gas, generated from oxygen by electrical discharge.; Fresh air, especially that breathed at the seaside and smelling of seaweed.(v) To treat with ozone.
