e: (C) The fifth letter of the English alphabet, called e and written in the Latin script.(0) The ordinal number fifth, derived from this letter of the English alphabet, called e and written in the Latin script.(S) (a) an initial letter ⟨e⟩(n) The name of the Latin-script letter E.
E: (C) The fifth letter of the English alphabet, called e and written in the Latin script.(0) The ordinal number fifth, derived from this letter of the English alphabet, called e and written in the Latin script.(S) East.(n) The drug ecstasy (MDMA), particularly in pill form.; The hormone estrogen/estradiol. (Contrast T, testosterone.); The grade below D in some grading systems. In most such systems, it is a failing grade.(N) A state in ancient China of varying location in present-day Shanxi, Henan, and Hubei.; Its capital, also known as Echeng and Ezhou.; A surname, from Chinese.(N) A Tai-Chinese mixed language spoken primarily in Rongshui Miao Autonomous County, Guangxi, China; Kjang E.(N) A river in the Highlands of Scotland.
ea: (n) A river or watercourse.(d) Alternative form of ea.
Ea: (N) Name of Enki in Akkadian and Babylonian mythology.
each: (d) All; every; qualifying a singular noun, indicating all examples of the thing so named seen as individual or separate items (compare every).(av) For one; apiece; per.(P) Every one/thing individually or one by one.(n) An individual item: the least quantitative unit in a grouping.
eager: (aj) Desirous; keen to do or obtain something.; Not employing lazy evaluation; calculating results immediately, rather than deferring calculation until they are required.; Brittle; inflexible; not ductile.; Sharp; sour; acid.; Sharp; keen; bitter; severe.(n) Alternative form of eagre (tidal bore).
Eager: (N) A surname.
eagle: (n) Any of several large carnivorous and carrion-eating birds in the family Accipitridae, having a powerful hooked bill and keen vision.; A gold coin with a face value of ten dollars, formerly used in the United States.; A 13th-century coin minted in Europe and circulated in England as a debased sterling silver penny, outlawed under Edward I of England.; A score of two under par for a hole.(v) To score an eagle.
Eagle: (N) The Apollo Lunar Module of Apollo 11.(N) A surname, from nicknames, from the name of the bird as a byname. See eagle.; A city in Alaska.; Any of a number of rivers in the United States and Canada.; A town, the county seat of Eagle County, Colorado, United States.; A city in Idaho.; A village in Michigan.; A village in Nebraska.; A town in New York.; A village in Wisconsin.(n) An Eagle Scout.; An advancement to the Eagle Scout rank.
eagles: (n) plural of eagle(v) Third-person singular simple present indicative form of eagle
Eagles: (n) plural of Eagle(N) A surname.; The Philadelphia Eagles
eaglet: (n) The immature young of an eagle; an eagle chick.
eagre: (aj) Obsolete form of eager.(n) a tidal bore
Ealing: (N) A London borough of Greater London, England.; A town in West London, Greater London, England.; A rural locality in south Canterbury, New Zealand.
ear: (n) The organ of hearing, consisting of the pinna, auditory canal, eardrum, malleus, incus, stapes and cochlea.; The external part of the organ of hearing, the auricle.; A police informant.; The sense of hearing; the perception of sounds; skill or good taste in listening to music.; The privilege of being kindly heard; favour; attention.; That which resembles in shape or position the ear of an animal; a prominence or projection on an object, usually for support or attachment; a lug; a handle.; An acroterium.; A crossette.; A space to the left or right of a publication's front-page title, used for advertising, weather, etc.(v) To take in with the ears; to hear.; To hold by the ears.(n) The fruiting body of a grain plant.(v) To put forth ears in growing; to form ears, as grain does.(v) To plough.
eared: (aj) Having ears (of a specified type).(v) simple past tense and past participle of ear
earful: (n) an angry reprimand, castigation or telling off; intimate gossip
earing: (n) A line used to fasten the upper corners of a sail to the yard or gaff; also called head earing.; A line for hauling the reef cringle to the yard; also called reef earing.; A line fastening the corners of an awning to the rigging or stanchions.; A ploughing of land.
earl: (n) A British or Irish nobleman next in rank above a viscount and below a marquess; equivalent to a European count. A female using the style is termed a countess.; Any of various nymphalid butterflies of the genus Tanaecia. Other butterflies in this genus are called counts and viscounts.
Earl: (N) The title of an earl.; A male given name from English from the English noun earl.; A surname, from occupations for service in the household of an earl, or from a nickname.; A female given name
earlap: (n) The ear lobe.; A flap connected to headgear to protect the ear (against the cold, or physical harm); an earflap.
earls: (n) plural of earl
early: (aj) At a time in advance of the usual or expected event.; Arriving a time before expected; sooner than on time.; Near the start or beginning.; Near the start of the day.; Having begun to occur; in its early stages.; Of a star or class of stars, hotter than the sun.(n) A shift (scheduled work period) that takes place early in the day.(av) At a time before expected; sooner than usual.; Soon; in good time; seasonably.
Early: (N) A surname.
earn: (v) To gain (success, reward, recognition) through applied effort or work.; To receive payment for work.; To receive payment for work.; To cause (someone) to receive payment or reward.; To achieve by being worthy of.(v) To curdle (milk), especially in the cheesemaking process.; Of milk: to curdle, espcially in the cheesemaking process.(v) To strongly long or yearn (for something or to do something).; To grieve.(n) Alternative form of erne
Earn: (N) A river in Scotland which flows into the tidal River Tay.
earned: (v) simple past tense and past participle of earn
earns: (v) Third-person singular simple present indicative form of earn
ears: (n) plural of ear(v) Third-person singular simple present indicative form of ear
earth: (N) Alternative letter-case form of Earth; Our planet, third out from the Sun.(n) Soil.; Any general rock-based material.; The ground, land (as opposed to the sky or sea).; A connection electrically to the earth ((US) ground); on equipment: a terminal connected in that manner.; The lair or den (as a hole in the ground) of an animal such as a fox.; A region of the planet; a land or country.; Worldly things, as against spiritual ones.; The world of our current life (as opposed to heaven or an afterlife).; The people on the globe.; Any planet similar to the Earth (our earth): an exoplanet viewed as another earth, or a potential one.; The human body.; The aforementioned soil- or rock-based material, considered one of the four or five classical elements.; Any of certain substances now known to be oxides of metal, which were distinguished by being infusible, and by insolubility in water.(v) To connect electrically to the earth.; To bury.; To hide, or cause to hide, in the earth; to chase into a burrow or den.; To burrow.
Earth: (N) The third planet of the Solar System; the world upon which humans live.; The personification of the Earth or earth, (chiefly) as a fertile woman or (religion) goddess.
earths: (n) plural of earth(v) Third-person singular simple present indicative form of earth
Earths: (N) plural of Earth
earthy: (aj) Resembling dirt or soil (i.e. earth).; Down-to-earth, not artificial, natural.; Coarse and unrefined, crude.; Like or resembling the earth or of the earth.; Covered with earth (mud, dirt).
earwax: (n) A waxy substance secreted by the ear.
earwaxes: (n) plural of earwax
earwig: (n) Any of various insects of the order Dermaptera that have elongated bodies, large membranous wings folded underneath short leathery forewings and a pair of large pincers protruding from the rear of the abdomen.; One who whispers insinuations; a secret counsellor.; A flatterer.(v) To fill the mind of with prejudice by insinuations.; To attempt to influence by persistent confidential argument or talk.; To eavesdrop.; To eavesdrop on.
eas: (n) plural of ea
ease: (n) Ability, the means to do something, particularly; Skill, dexterity, facility.; Comfort, a state or quality lacking unpleasantness; Freedom from pain, hardship, and annoyance, sometimes (derogatory, archaic) idleness, sloth.; Comfort, a state or quality lacking unpleasantness; Freedom from worry and concern; peace; sometimes (derogatory, archaic) indifference.; Comfort, a state or quality lacking unpleasantness; Freedom from difficulty.; Comfort, a state or quality lacking unpleasantness; Freedom from effort, leisure, rest.; Comfort, a state or quality lacking unpleasantness; Freedom from financial effort or worry; affluence.; Comfort, a state or quality lacking unpleasantness; Freedom from embarrassment or awkwardness; grace.; Relief, an end to discomfort; Followed by of or from: release from or reduction of pain, hardship, or annoyance.; Relief, an end to discomfort; Release from intestinal discomfort: defecation.; Relief, an end to discomfort; Release from constraint, obligation, or a constrained position.; Relief, an end to discomfort; Additional space provided to allow greater movement.; A convenience; a luxury.; A relief; an easement.(v) To free (something) from pain, worry, agitation, etc.; To alleviate, assuage or lessen (pain).; To give respite to (someone).; To loosen or slacken the tension on a line.; To reduce the difficulty of (something).; To move (something) slowly and carefully.; To lessen in intensity.; To proceed with little effort.
eased: (v) past participle of ease
easel: (n) An upright frame, typically on three legs, for displaying or supporting something, such as an artist's canvas.
eases: (v) Third-person singular simple present indicative form of ease
easier: (aj) comparative form of easy: more easy(av) comparative form of easy: more easy; more easily
easily: (av) Comfortably, without discomfort or anxiety.; Without difficulty.; Absolutely, without question.
easing: (v) present participle of ease(n) The act by which something is eased.
east: (n) One of the four principal compass points, specifically 90°, conventionally directed to the right on maps; the direction of the rising sun at an equinox. Abbreviated as E.; The eastern region or area; the inhabitants thereof.; In a church: the direction of the altar and chancel; the direction faced by the priest when celebrating ad orientem.(aj) Situated or lying in or towards the east; eastward.; Blowing (as wind) from the east.; Of or pertaining to the east; eastern.; From the East; oriental.; Designating, or situated in, the liturgical east.(av) towards the east; eastwards
East: (N) A personification of the wind from the east.; The Eastern world; the regions, primarily situated in the Eastern Hemisphere, whose culture is derived from Arabia, India, Persia or China.; The Eastern Bloc; the eastern countries of Europe.; the Soviet Union and its socialist allies during the Cold War.; The eastern states of the United States.; The eastern part of any region.; A surname.
easted: (v) plural of east
easter: (aj) Eastern.; comparative form of east: more east(n) A strong easterly wind (a wind blowing from the east).(v) To move toward the east.
Easter: (n) A Christian feast commemorating the resurrection of Jesus Christ, celebrated on the first Sunday (and Monday) following the full moon that occurs on or next after the vernal equinox, ranging in most of Western Christianity (such as Protestantism and Roman Catholicism) from March 22 to April 25, and in Eastern Christianity (such as the Coptic Church and Eastern Orthodox Church) from April 4 to May 8.; Eastertide (“the period from Easter to Whitsun”).; Usually preceded by an inflection of make: the act of receiving the Eucharist during Easter.; Ellipsis of Easter term; A festival held in honour of the goddess Eostre or Ostara, celebrated at the vernal equinox or within the month of April; Eostre, Ostara.; The Jewish Passover.(N) A surname.(v) To celebrate Easter.; To spend the Easter season in some place.
easy: (aj) Comfortable; at ease.; Requiring little skill or effort.; Causing ease; giving comfort, or freedom from care or labour.; Free from constraint, harshness, or formality; unconstrained; smooth.; Consenting readily to sex.; Not making resistance or showing unwillingness; tractable; yielding; compliant.; Not straitened as to money matters; opposed to tight.(av) In a relaxed or casual manner.; In a manner without strictness or harshness.; At the very least.(n) Something that is easy(v) Synonym of easy-oar
eat: (v) To ingest; to be ingested.; To consume (something solid or semi-solid, usually food) by putting it into the mouth and swallowing it.; To ingest; to be ingested.; To consume a meal.; To ingest; to be ingested.; To be eaten.; To ingest; to be ingested.; To have a particular quality of diet; to be well-fed or underfed (typically as "eat healthy" or "eat good").; To use up.; To destroy, consume, or use up.; To use up.; To consume (an exception, an event, etc.) so that other parts of the program do not receive it.; To use up.; To damage, destroy, or fail to eject a removable part or an inserted object.; To use up.; To consume money (or other instruments of value, such as a token) deposited or inserted by a user, while failing to either provide the intended product or service, or return the payment.; To cause (someone) to worry.; To take the loss in a transaction.; To be injured or killed by (something such as a firearm or its projectile), especially in the mouth.; To corrode or erode.; To perform oral sex (on a person or body part).; To be very good, to rule, rock.(n) Something to be eaten; a meal; a food item.
eatage: (n) Edible growth of grass for horses and cattle, especially that of aftermath.; The right to let one's animals eat in a certain place; pasturage.
eaten: (v) past participle of eat(aj) That has been consumed by eating
eater: (n) One who eats.; An eating apple.; One who performs fellatio or cunnilingus.; A configuration of cells that appears to consume another configuration by gradually causing it to disappear.
eaters: (n) plural of eater
eating: (v) present participle of eat(aj) Bred to be eaten.; Suitable to be eaten without being cooked.(n) The act of ingesting food.; Food; cooking, cuisine.; The act of corroding or consuming some substance.
eats: (v) Third-person singular simple present indicative form of eat(n) Food.
eau: (n) A brook, a stream, a river; especially in placenames (Eau).
Eau: (N) Any of several rivers in Lincolnshire
eaux: (n) plural of eau
Eaves: (N) A surname.; A hamlet in Woodplumpton parish, city of Preston district, Lancashire, England (OS grid ref SD4937).
ebb: (n) The receding movement of the tide.; A gradual decline.; A low state; a state of depression.; A European bunting, the corn bunting (Emberiza calandra, syns. Emberiza miliaria, Milaria calandra).(v) to flow back or recede; to fall away or decline; to fish with stakes and nets that serve to prevent the fish from getting back into the sea with the ebb; To cause to flow back.(aj) low, shallow
ebbed: (v) simple past tense and past participle of ebb
ebbing: (v) present participle of ebb(n) The action of something that ebbs.
ebbs: (n) plural of ebb(v) Third-person singular simple present indicative form of ebb
Eblis: (N) Alternative form of Iblis
ebon: (n) Ebony; an ebony tree.(aj) Made of ebony.; Black in colour.
ebony: (n) A hard, dense, deep black wood from various subtropical and tropical trees, especially of the genus Diospyros.; A tree that yields such wood.; A deep, dark black colour.; A black key on a piano or other keyboard instrument.(aj) Made of ebony wood.; A deep, dark black colour.; Dark-skinned; black; especially in reference to African-Americans.
Ebony: (N) A female given name from English.
Ebro: (N) A river in Spain that flows into the Mediterranean.
Eccles: (N) A town in Salford, Greater Manchester, England.; A surname.
ecesis: (n) The process of successful establishment of a plant or animal species in a habitat that was barren previously/ or was left barren due to some catastrophe.
ecesises: (n) plural of ecesis
echo: (n) A reflected sound that is heard again by its initial observer.; An utterance repeating what has just been said.; A device in verse in which a line ends with a word which recalls the sound of the last word of the preceding line.; Sympathetic recognition; response; answer.; The displaying on the command line of the command that has just been executed.; Echo, the letter E in the ICAO spelling alphabet.; A signal, played in the same manner as a trump signal, made by a player who holds four or more trumps (or, as played by some, exactly three trumps) and whose partner has led trumps or signalled for trumps.; A signal showing the number held of a plain suit when a high card in that suit is led by one's partner.; An antisemitic punctuation symbol or marking, ((( ))), placed around a name or phrase to indicate the person is Jewish or the entity is controlled by Jewish people.; Clipping of echocardiography.; Clipping of echocardiogram.(v) To reflect off a surface and return.; To reflect back (a sound).; To repeat (another's speech, opinion, etc.).; To repeat its input as input to some other device or system.; To give the echo signal, informing one's partner about cards one holds.
Echo: (N) An oread, punished by Hera by losing her own voice and only being able to mimic that of others.; 60 Echo, a main belt asteroid.
echoed: (v) simple past tense and past participle of echo
echoes: (n) plural of echo(v) Third-person singular simple present indicative form of echo
echoic: (aj) Of or pertaining to an echo; Imitative of a sound; onomatopoeic.
echt: (aj) proper, real, genuine, true to type
eclair: (n) Alternative spelling of éclair
eclat: (n) Alternative spelling of éclat
ecru: (n) A beige colour.(aj) Of a beige colour.
ectype: (n) A copy, usually contrasted with the original, or archetype.; An idea or impression that corresponds to external reality.
eczema: (n) A non-contagious acute or chronic inflammation of the skin, characterized by redness, itching, and the outbreak of oozing vesicular lesions which become encrusted and scaly.
ed: (n) edition; editor; education (uncountable)(n) Education. Often used in set phrases such as phys ed, driver's ed, special ed, etc.
Ed: (N) A diminutive of Edward, Edgar, Edwin, or other male given names beginning with Ed-.
Edam: (N) A town in Holland; Edam cheese.
Edda: (N) A collection of Old Norse poems and tales from two medieval manuscripts found in Iceland.
eddied: (v) simple past tense and past participle of eddy
eddies: (n) plural of eddy(v) Third-person singular simple present indicative form of eddy
eddo: (n) A plant (Colocasia esculenta, but often identified as Colocasia antiquorum, among numerous other synonyms), which is usually considered a variety of C. esculenta, with edible starchy tubers.; The tubers of this plant.
eddy: (n) A current of air or water running back, or in an opposite direction to the main current.; A circular current; a whirlpool.(v) To form an eddy; to move in, or as if in, an eddy; to move in a circle.
Eddy: (N) A diminutive of Edward, Edgar, Edwin, or other male given names beginning with Ed-.; A surname.
edema: (n) An excessive accumulation of serum in tissue spaces or a body cavity.; A similar swelling in plants caused by excessive accumulation of water.
eden: (n) Alternative letter-case form of Eden (“a paradise”)
Eden: (N) A garden built by God as the home for Adam and Eve; sometimes identified as part of Mesopotamia.; An English surname, probably derived from a place name.; A female given name from Hebrew from the biblical place name; also a medieval diminutive of Old English compound names beginning with the element ēad (“riches”).; Any of various towns and other place names.; A coastal town in New South Wales, Australia.; Any of various towns and other place names.; A small unincorporated community in Graham County, Arizona.; Any of various towns and other place names.; A city and town in Jerome County, Idaho.; Any of various towns and other place names.; An unincorporated community in Peoria County, Illinois.; Any of various towns and other place names.; An unincorporated community in Randolph County, Illinois.; Any of various towns and other place names.; An unincorporated community in Hancock County, Indiana.; Any of various towns and other place names.; A small unincorporated community in Atchison County, Kansas.; Any of various towns and other place names.; An unincorporated community in Butler County, Kentucky.; Any of various towns and other place names.; A census-designated place in Somerset County, Maryland.; Any of various towns and other place names.; An unincorporated community in Dodge County, Minnesota.; Any of various towns and other place names.; A village in Yazoo County, Mississippi.; Any of various towns and other place names.; A town in Erie County, New York.; Any of various towns and other place names.; A city in Rockingham County, North Carolina.; Any of various towns and other place names.; A small town and village in Marshall County, South Dakota.; Any of various towns and other place names.; A small city in Concho County, Texas.; Any of various towns and other place names.; A census-designated place in Weber County, Utah.; Any of various towns and other place names.; A town in Lamoille County, Vermont.; Any of various towns and other place names.; An unincorporated community in Wahkiakum County, Washington.; Any of various towns and other place names.; An unincorporated community in Boone County, West Virginia.; Any of various towns and other place names.; An unincorporated community in Ohio County, West Virginia.; Any of various towns and other place names.; An unincorporated community in Upshur County, West Virginia.; Any of various towns and other place names.; A town and village in Fond du Lac County, Wisconsin.; Any of various towns and other place names.; A small town in Iowa County, Wisconsin.; Any of various towns and other place names.; A census-designated place in Sweetwater County, Wyoming.(n) A paradise on Earth.; A state of innocence.(N) A river in Cumbria, England, which passes Carlisle and empties into the Solway Firth.; A river in Kent, England, which flows into the Medway; the name is a back-formation of Edenbridge.; A river in Fife council area, Scotland, which flows into the North Sea.; Eden Water, a small river in the Scottish Borders council area, which flows into the River Tweed.; Eden District, a local government district of Cumbria, England formed in 1974 and named after the Cumbrian river, with its headquarters in Penrith.; A residential settlement in County Antrim, Ireland.; Three townlands in County Londonderry, Northern Ireland.; A townland in County Tyrone, Northern Ireland.
Edgar: (N) A male given name from Old English.; A patronymic surname, from given names.
edge: (n) The boundary line of a surface.; A one-dimensional face of a polytope. In particular, the joining line between two vertices of a polygon; the place where two faces of a polyhedron meet.; An advantage.; The thin cutting side of the blade of an instrument, such as an ax, knife, sword, or scythe; that which cuts as an edge does, or wounds deeply, etc.; A sharp terminating border; a margin; a brink; an extreme verge.; Sharpness; readiness or fitness to cut; keenness; intenseness of desire.; The border or part adjacent to the line of division; the beginning or early part (of a period of time); A shot where the ball comes off the edge of the bat, often unintentionally.; A connected pair of vertices in a graph.; In human sexuality, a level of sexual arousal that is maintained just short of reaching the point of inevitability, or climax; see also edging.(v) To move an object slowly and carefully in a particular direction.; To move slowly and carefully in a particular direction.; To win by a small margin.; To hit the ball with an edge of the bat, causing a fine deflection.; To trim the margin of a lawn where the grass meets the sidewalk, usually with an electric or gas-powered lawn edger.; To furnish with an edge; to construct an edging.; To furnish with an edge, as a tool or weapon; to sharpen.; To make sharp or keen; to incite; to exasperate; to goad; to urge or egg on.; To delay one's orgasm so as to remain almost at the point of orgasm.
EDGE: (n) Explain, demonstrate, guide, enable; an educating method.; Notation for an edge rusher.
Edge: (N) A surname.; Microsoft Edge
edged: (v) simple past tense and past participle of edge(aj) That has a sharp planar surface.; followed by with: Having an edging of a certain material, color, and so on.
edger: (n) A tool that is used to trim the edges of a lawn.
edges: (n) plural of edge; The fine hairs at the edge of someone's (usually a black woman's) hairline; baby hairs.(v) Third-person singular simple present indicative form of edge
edging: (v) present participle of edge
edgy: (aj) Nervous, apprehensive.; Creatively challenging; cutting edge; leading edge.; On the edge between acceptable and offensive; pushing the boundaries of good taste; risqué.; Irritable.; Having some of the forms, such as drapery or the like, too sharply defined.; Sharp.; Cool by virtue of being tough, dark, or badass.; Exhibiting behavior that is disconcerting or alarming, sometimes in an effort to impress or to troll others.
edh: (n) Alternative form of eth
edible: (aj) Capable of being eaten without harm; suitable for consumption; innocuous to humans.; Capable of being eaten without disgust.; In which edible plants are grown for human consumption.(n) Anything edible.; In particular, an edible mushroom.; a foodstuff, usually a baked good, infused with tetrahydrocannabinol from cannabutter etc.
edict: (n) A proclamation of law or other authoritative command.
edicts: (n) plural of edict
edify: (v) To build, construct.; To instruct or improve morally or intellectually.
edile: (n) Alternative spelling of aedile
Edison: (N) An English patronymic or matronymic (or just pamatronymic) surname derived from Adam and Edith.; Thomas Edison (1847–1931), American inventor and businessman.; An unincorporated community in Kern County, California, United States.; A small city in Calhoun County, Georgia, United States.; A village in Furnas County, Nebraska, United States.; A township in Middlesex County, New Jersey, renamed after Thomas Edison, who had his main laboratory here, in 1955.; A village in Morrow County, Ohio, United States.; A census-designated place in Skagit County, Washington, United States.; An unincorporated community in Mercer County, West Virginia, United States.; A former unincorporated community in Alberta, Canada, near modern Westlock; named after Thomas Edison.
edit: (n) A change to the text of a document.; A change in the text of a file, a website or the code of software.; An edited piece of media, especially video footage.; An interruption or change to an improvised scene.; An alteration to the DNA sequence of a chromosome; an act of gene splicing.(v) To change a text, or a document.; To alter a photograph or recording of sound or video.; To be the editor of a publication.; To change the contents of a file, website, etc.; To alter the DNA sequence of a chromosome; to perform gene splicing.; To assemble a film by cutting and splicing raw footage.; To cut short or otherwise alter an improvised scene.; To lend itself to editing in a certain way.
edited: (v) simple past tense and past participle of edit(aj) Having been altered from the original version.
editor: (n) A person who edits or makes changes to documents.; A copy editor.; A person who edited a specific document.; A person at a newspaper, publisher or similar institution who edits stories and/or decides which ones to publish.; A machine used for editing (cutting and splicing) movie film; A program for creating and making changes to files, especially text files.; Someone who manipulates video footage and assembles it into the correct order etc for broadcast; a picture editor.
Edom: (N) The name given to Esau in the Hebrew Bible.; A region whose inhabitants, the Edomites, traditionally traced their ancestry to Esau.; Rome, the Roman Empire.; Christianity.
educe: (v) To direct the course of (a flow, journey etc.); to lead in a particular direction.; To infer or deduce (a result, theory etc.) from existing data or premises.; To draw out or bring forth from some basic or potential state; to elicit, to develop.; To isolate (a substance) from a compound; to extract.; To cause or generate; to bring about.(n) An inference.
educt: (n) That which is educed.; A reactant.(v) To educe, to extract.
Edward: (N) A male given name from Old English.; A surname. See also Edwards.(n) A gold coin produced in the rein of King Edward.
Edwin: (N) A male given name from Old English.; Edwin of Northumbria.; A surname.; An unincorporated community in Henry County, Alabama, United States.
ee: (n) An eye.(i) eh(n) Enantiomeric excess.
eel: (n) Any freshwater or marine fish of the order Anguilliformes, which are elongated and resemble snakes.; The European eel, Anguilla anguilla.(v) To fish for eels.; To move with a sinuous motion like that of an eel.
eels: (n) plural of eel(v) Third-person singular simple present indicative form of eel
een: (n) plural of eye(av) even.(n) evening.
eer: (av) Unpunctuated contraction of ever.
eerie: (aj) Strange, weird, fear-inspiring.; Frightened, timid.
ef: (n) The name of the Latin-script letter F.(c) Pronunciation spelling of if, representing dialectal English.
EF: (N) Followed by a number from 0 to 5: initialism of Enhanced Fujita, a rating on the Enhanced Fujita scale used to indicate the intensity of a tornado. It has superseded the Fujita scale.
efface: (v) To erase (as anything impressed or inscribed upon a surface); to render illegible or indiscernible.; To cause to disappear as if by rubbing out or striking out.; To make oneself inobtrusive as if due to modesty or diffidence.; Of the cervix during pregnancy, to thin and stretch in preparation for labor.
effect: (n) The result or outcome of a cause.; Impression left on the mind; sensation produced.; Execution; performance; realization; operation.; The state of being binding and enforceable, as in a rule, policy, or law.; An illusion produced by technical means (as in "special effect"); An alteration, or device for producing an alteration, in sound after it has been produced by an instrument.; A scientific phenomenon, usually named after its discoverer.; Belongings, usually as personal effects.; Consequence intended; purpose; meaning; general intent; with to.; Reality; actual meaning; fact, as distinguished from mere appearance.; Manifestation; expression; sign.(v) To make or bring about; to implement.; Misspelling of affect.
effete: (aj) Of substances, quantities etc: exhausted, spent, worn-out.; Lacking strength or vitality; feeble, powerless, impotent.; Decadent, weak through self-indulgence.; Affected, overrefined
effigy: (n) A dummy or other crude representation of a person, group or object that is hated.; A likeness of a person.
efflux: (n) The process of flowing out.; That which has flowed out.(v) To run out; to flow forth.; To pass away.
effort: (n) The work involved in performing an activity; exertion.; An endeavor.; A force acting on a body in the direction of its motion.(v) To make an effort.; To strengthen, fortify or stimulate
effuse: (aj) Poured out freely; profuse.; Disposed to pour out freely; prodigal.; Spreading loosely, especially on one side.; Having the lips, or edges, of the aperture abruptly spreading, as in certain shells.(v) To emit; to give off.; To gush; to be excitedly talkative and enthusiastic about something.; To pour out like a stream or freely; to cause to exude; to shed.; To leak out through a small hole.(n) effusion; loss
Efik: (n) A member of an ethnic group located primarily in southeastern Nigeria.(N) The language of these people.
eft: (n) A newt, especially the European smooth newt (Lissotriton vulgaris, syn. Triturus punctatus).(av) Again; afterwards
egad: (i) a mild exclamation of surprise, contempt, outrage, etc.
egal: (aj) Equal; impartial.
Egbert: (N) A male given name from Old English.
eger: (n) Alternative spelling of eagre
Eger: (N) A city in Hungary.
Egeria: (N) A nymph or minor goddess from Roman mythology.; 13 Egeria, a main belt asteroid.(n) A patroness.
egest: (v) To eliminate undigested food or waste from the body (as feces).
egesta: (n) The waste which is carried out from a cell or an organism; the result of egestion; excrement
egg: (n) An approximately spherical or ellipsoidal body produced by birds, reptiles, insects and other animals, housing the embryo during its development.; The egg of a domestic fowl (especially a hen) or its contents, used as food.; The female primary cell, the ovum.; Anything shaped like an egg, such as an Easter egg or a chocolate egg.; A swelling on one's head, usually large or noticeable, associated with an injury.; A white person considered to be overly infatuated with East Asia.; A foolish or obnoxious person.; A young person.; A person, fellow.; A person who is regarded as having not yet realized they are transgender, has not yet come out, or is in the early stages of transitioning.; One of the blocks of data injected into a program's address space for use by certain forms of shellcode, such as "omelettes".; A user of the microblogging service Twitter who has the default avatar rather than a custom picture (previously an egg); a noob.(v) To throw eggs (the food item) at.; To dip in or coat with beaten egg (the food item).; To distort a circular cross-section (as in a tube) to an elliptical or oval shape, either inadvertently or intentionally.(v) To encourage, incite.
Egg: (N) A surname.; A Koenigsegg car.
eggcup: (n) A small dish used to support a boiled egg while it is eaten.
egged: (v) simple past tense and past participle of egg
egger: (n) One who gathers eggs.(n) An eggar moth; any of various species of family Lasiocampidae, especially the oak eggar-moth, Lasiocampa quercus.(n) One who eggs or incites.
Egger: (N) A surname.
eggnog: (n) A beverage based on milk, eggs, sugar, and nutmeg; often made alcoholic with rum, brandy or whisky; popular at Christmas.
eggs: (n) plural of egg(v) Third-person singular simple present indicative form of egg
egis: (n) Alternative spelling of aegis.
ego: (n) The self, especially with a sense of self-importance.; The most central part of the mind, which mediates with one's surroundings.
egoism: (n) The tendency to think selfishly with exclusive self-interest in mind.; The belief that moral behavior should be directed toward one's self-interest only.; Egotism (tendency to talk excessively about oneself).
egoist: (n) An advocate of egoism.; An egocentric or self-centered person.; An egotist (person who talks excessively about themself).
egress: (n) An exit or way out.; The process of exiting or leaving.; The end of the apparent transit of a small astronomical body over the disk of a larger one.(v) To exit or leave; to go or come out.
egret: (n) Any of various wading birds of the genera Egretta or Ardea that includes herons, many of which are white or buff, and several of which develop fine plumes during the breeding season.; A plume or tuft of feathers worn as a part of a headdress, or anything imitating such an ornament.; The flying feathery or hairy crown of seeds or achenes, such as the down of the thistle.; The crab-eating macaque (Macaca fascicularis)
Egypt: (N) A country in North Africa. Official name: Arab Republic of Egypt.; A civilization based around the river Nile, on its lower reaches nearer the Mediterranean.
eh: (i) Used as a tag question, to emphasise what goes before or to request that the listener express an opinion about what has been said.; In isolation, a request for repetition or clarification of what has just been said. Compare what, pardon.; An interjection used to ascertain the continued attention of an individual addressed by the speaker; Expressing apathy or lack of enthusiasm; meh.(v) To use the interjection eh(aj) Of mediocre quality; unremarkable.
eH: (S) redox potential (in volts).
eider: (n) Any of the species of the genera Polysticta or Somateria, in the seaduck subfamily Merginae, which line their nests with fine down (taken from their own bodies).
Eider: (N) A river in Germany, the boundary between Schleswig and Holstein.
Eiffel: (N) A surname, from French.; An ISO-standardized, object-oriented programming language.
eight: (0) A numerical value equal to 8; the number occurring after seven and before nine.; Describing a group or set with eight elements.(n) The digit/figure 8.; Any of the four cards in a normal deck with the value eight.; A light, narrow rowing boat, especially one used in competitive rowing, steered by a cox, in which eight rowers each have two oars.; A race in which such craft participate.; The eight people who crew a rowing-boat.(aj) Obsolete spelling of eighth(n) Alternative spelling of ait (island in a river)
eighth: (aj) The ordinal form of the number eight.(n) The person or thing in the eighth position.; One of eight equal parts of a whole.; An eighth of an ounce, or approximately 3.5 grams, of marijuana or other drugs.(v) to divide by eight
eighty: (0) The cardinal number occurring after seventy-nine and before eighty-one, represented in Roman numerals as LXXX and in Arabic numerals as 80.
eigne: (aj) eldest; firstborn; entailed; belonging to the eldest son
eikon: (n) Alternative spelling of icon (“religious image”)
Eire: (N) The Republic of Ireland.; The island of Ireland, consisting of the Republic of Ireland and Northern Ireland
either: (d) Any one (of two).; Each of two; both.; Any one (of more than two).(P) One or the other of two people or things.; Both, each of two or more.(av) As well.(c) Introduces the first of two (or occasionally more) options or possibilities, the second (or last) of which is introduced by “or”.
eject: (v) To compel (a person or persons) to leave.; To throw out or remove forcefully.; To compel (a sports player) to leave the field because of inappropriate behaviour.; To forcefully project oneself or another occupant from an aircraft (or, rarely, another type of vehicle), typically using an ejection seat or escape capsule.; To cause (something) to come out of a machine.; To come out of a machine.(n) an inferred object of someone else's consciousness
ejecta: (n) Material which has been ejected, especially from a volcano or an impact crater.
eke: (n) An addition.; A small stand on which a beehive is placed.; A spacer put between or over or under hive parts to make more space.(v) Chiefly in the form eke out: to add to, to augment; to increase; to lengthen.(av) Also; in addition to.
eked: (v) simple past tense and past participle of eke
el: (n) The name of the Latin-script letter L.(n) An elevated railway, especially for specific systems such as the metro in Chicago.(0) The cardinal number occurring after dek and before do in a duodecimal system. Written ↋, decimal value 11.(a) the
El: (N) Any of several major ancient Near East deities, including the supreme god of the Canaanite religion, but especially the supreme Hebrew God.
elaine: (n) Alternative form of olein
Elaine: (N) A female given name from Ancient Greek.
elan: (n) Uncommon spelling of élan.
eland: (n) A genus of large South African antelope (Taurotragus), valued both for its hide and flesh.
Eland: (N) A surname.(N) A village in Shawano County, Wisconsin, United States.
elapid: (n) Any of many species of snakes of the family Elapidae, including the cobras, mambas, and coral snakes(aj) Characteristic of these snakes
elapse: (v) To pass or move by.
elate: (v) To make joyful or proud.; To lift up; raise; elevate.(aj) elated; exultant; Lifted up; raised; elevated.
elated: (aj) Extremely happy and excited; delighted; pleased, euphoric.(v) simple past tense and past participle of elate
elater: (n) That which elates.(n) Elasticity; especially the expansibility of a gas.; A long, slender cell produced among spores and having hygroscopic secondary cell wall thickenings.; Any of the long, slender hygroscopic appendages attached to the spores of horsetails (genus Equisetum).; An elaterid, or click beetle.
Elba: (N) An Italian island in the Tuscan Archipelago off the west coast of Italy, between the Italian coast and Corsica; A city, the county seat of Coffee County, Alabama, United States
Elbe: (N) A river in central Europe that passes through the Czech Republic and Germany before flowing into the North Sea.
elbow: (n) The joint between the upper arm and the forearm.; Any turn or bend like that of the elbow, in a wall, building, coastline, etc.; an angular or jointed part of any structure, such as the raised arm of a chair or sofa, or a short pipe fitting, turning at an angle or bent.; A detective.; Part of a basketball court located at the intersection of the free-throw line and the free-throw lane.; A hit with the elbow.; Two nearby crossings of a rope.(v) To push with the elbow or elbows; to forge ahead using the elbows to assist.; To nudge, jostle or push.; To make someone quit or lose their job so that someone else can get it.
elbows: (n) plural of elbow(v) Third-person singular simple present indicative form of elbow
eld: (n) One's age, age in years, period of life.; Old age, senility; an old person.; Time; an age, an indefinitely long period of time.; Former ages, antiquity, olden times.(aj) Old.(v) To age, become or grow old.; To delay; linger.; To make old, age.
elder: (aj) comparative degree of old: older, greater than another in age or seniority.(n) An older person or an older member, usually a leader, of some community.; One who is older than another.; One who lived at an earlier period; a predecessor.; An officer of a church, sometimes having teaching responsibilities.; A clergyman authorized to administer all the sacraments.; One ordained to the lowest office in the Melchizedek priesthood.; Male missionary.; Title for a male missionary; title for a general authority.; A pagan or Heathen priest or priestess.(v) To admonish or reprove for improper conduct by the elders of the meeting.(n) A small tree, Sambucus nigra, having white flowers in a cluster, and edible purple berries; Any of the other species of the genus Sambucus: small trees, shrubs or herbaceous perennials with red, purple, or white/yellow berries (some of which are poisonous).(n) A cow's udder, especially used as food.
Elder: (N) A surname.
elders: (n) plural of elder(v) Third-person singular simple present indicative form of elder
eldest: (aj) superlative form of old: most old; greatest in age or seniority.(aj) (of a player) Receiving cards from the dealer first, before any other players.; (of a hand) Having higher, or superior cards.(n) The eldest child in a family, or individual in a group.
elds: (n) plural of eld
elect: (n) One chosen or set apart.; In Calvinist theology, one foreordained to Heaven. In other Christian theologies, someone chosen by God for salvation.(v) To choose or make a decision (to do something); To choose (a candidate) in an election(aj) Who has been elected in a specified post, but has not yet entered office.; Chosen; taken by preference from among two or more.
elects: (v) Third-person singular simple present indicative form of elect(n) plural of elect
elegit: (n) A judicial writ ordering seizure of a debtor's property.
elegy: (n) A mournful or plaintive poem; a funeral song; a poem of lamentation.; A composition of mournful character.; A classical poem written in elegiac meter
elemi: (n) A tree, Canarium luzonicum, native to the Philippines.; A resin harvested from the tree.
eleven: (0) The cardinal number occurring after ten and before twelve. Represented as 11 in Arabic digits.(n) A cricket team of eleven players. Hence first eleven - the team of best cricket players (at a school), second eleven - the "B" team, etc.; A football team of eleven players; the starting lineup.; Used instead of ! to amplify an exclamation, imitating someone who forgets to press the shift key while typing exclamation points.; A number off the charts of a hypothetical scale of one to ten.; An exceptional specimen, (particularly) a physically attractive person.; A number off the charts of a hypothetical scale of one to ten.; A very high level of intensity.
elevon: (n) A movable surface at the trailing edge of a tailless airplane (such as the space shuttle) that provides pitch and roll control.
elf: (n) A luminous spirit presiding over nature and fertility and dwelling in the world of Álfheim (Elfland). Compare angel, nymph, fairy.; Any from a race of mythical, supernatural beings resembling but seen as distinct from human beings. They are usually delicate-featured and skilled in magic or spellcrafting; sometimes depicted as clashing with dwarves, especially in modern fantasy literature.; Any of the magical, typically forest-guarding races bearing some similarities to the Norse álfar (through Tolkien's Eldar).; A very diminutive person; a dwarf.; The bluefish (Pomatomus saltatrix).(v) To twist into elflocks (of hair); to mat.
elfin: (n) An elf; an inhabitant of fairy-land.; A little urchin or child.; Any of the butterflies in the subgenus Incisalia of the North American lycaenid genus Callophrys.(aj) Relating to or resembling an elf or elves, especially in its tiny size or features.
elfish: (aj) Characteristic of an elf; elfin, elven.; Mischievous.
elfishes: (n) plural of elfish
Elgar: (N) A male given name from Old English.; A patronymic surname, from given names.; Edward Elgar, an English composer.
Eli: (N) A male given name from Hebrew of Biblical origin.; The priest who brought up Samuel.(n) A student at Yale University.(N) Clipping of Elijah.; Clipping of Elisha.
Elias: (N) A male given name from Hebrew.; A surname.
elicit: (v) To evoke, educe (emotions, feelings, responses, etc.); to generate, obtain, or provoke as a response or answer.; To draw out, bring out, bring forth (something latent); to obtain information from someone or something.; To use logic to arrive at truth; to derive by reason(aj) Elicited; drawn out; made real; open; evident.
elide: (v) To leave out or omit (something).; To cut off, as a vowel or a syllable.; To conflate; to smear together; to blur the distinction between.
Elijah: (N) An Israelite prophet in the Abrahamic religions; A male given name from Hebrew.
Eliot: (N) An English and Scottish surname., variant of Elliott.; A male given name from Hebrew, variant of Elliott.
Elisha: (N) A prophet, a disciple and successor of Elijah.; A male given name from Hebrew of biblical origin, in quiet use since the 17th century.; A female given name from Hebrew in occasional use, apparently confused with Elizabeth or Alicia.
elite: (aj) Of high birth or social position; aristocratic or patrician.; Representing the choicest or most select of a group.(n) A special group or social class of people which have a superior intellectual, social or economic status as, the elite of society.; Someone who is among the best at a certain task.; A typeface with 12 characters per inch.
elixir: (n) A liquid which converts lead to gold.; A substance or liquid which is believed to cure all ills and give eternal life.; The alleged cure for all ailments; cure-all, panacea.; A sweet flavored liquid (usually containing a small amount of alcohol) used in compounding medicines to be taken by mouth in order to mask an unpleasant taste.
elk: (n) Any of various large species of deer such as the red deer, moose or wapiti (see usage notes).; The subspecies of the moose (Alces alces alces, alternatively named Eurasian elk to avoid confusion with the wapiti) that occurs only in Europe and Asia.; Any of various large species of deer such as the red deer, moose or wapiti (see usage notes).; Any moose (Alces alces), the largest member of the deer family.; Any of various large species of deer such as the red deer, moose or wapiti (see usage notes).; The common wapiti (Cervus canadensis), the second largest member of the deer family, once thought to be a subspecies of red deer.; Any of various large species of deer such as the red deer, moose or wapiti (see usage notes).; The sambar.(n) Alternative form of elke (the common swan (Cygnus cygnus, syn. Cygnus ferus))
Elk: (n) A member of the Benevolent and Protective Order of Elks, an American fraternal order.(n) An Acorn Electron computer.(N) A team member of the Canadian Football League's Edmonton Elks (formerly known as the Eskimos).(N) A surname, from Dutch.
ell: (n) A measure of length. An English ell was 1¼ yards (45 inches or 114 cm), whereas a Scottish ell measured only about 37 inches (94 cm) and a Flemish ell was ¾ yard (27 inches or 69 cm).(n) The name of the Latin-script letter L.; An extension usually at right angles to one end of a building.; Something that is L-shaped.
Ell: (N) A surname.
Ella: (N) A female given name.; Diminutive of Eleanor or Ellen; A female given name.; Clipping of Gabriella or Daniella.
ellen: (n) Zeal.; Strength; courage.; Strength vouchsafed; comfort; grace.
Ellen: (N) A female given name from Ancient Greek.
Ellis: (N) An English patronymic surname, from given names from Elis, the Middle English form of Elijah.; A patronymic surname, from Welsh and a male given name from Welsh, an anglicization of Elisedd.; A male given name transferred from the surname.; A locale in the United States.; A city in Kansas; named for American Civil War veteran George Ellis.; A locale in the United States.; An unincorporated community in Greene County, Indiana; named for politician William Ellis Niblack.; A locale in the United States.; An unincorporated community in Steuben County, Indiana.; A locale in the United States.; An unincorporated community in Minnesota.; A locale in the United States.; An unincorporated community in Missouri.; A locale in the United States.; An unincorporated community in Nebraska; named for banker John R. Ellis.; A locale in the United States.; An unincorporated community in Ohio; named for a local family.; A locale in the United States.; An unincorporated community in South Dakota; probably named for railroad worker A. B. Ellis.; A locale in the United States.; An unincorporated community in Wisconsin; named for politician Albert G. Ellis.
ells: (n) plural of ell
Ells: (N) plural of Ell
elm: (n) A tree of the genus Ulmus of the family Ulmaceae, large deciduous trees with alternate stipulate leaves and small apetalous flowers.; Wood from an elm tree.
Elm: (N) A village and civil parish in Fenland district, Cambridgeshire, England (OS grid ref TF4706).; An unincorporated community in Johnson County, Missouri, United States.; An unincorporated community in Lancaster County, Pennsylvania, United States.; A village in Glarus canton, Switzerland.; A surname.
elms: (n) plural of elm
Elohim: (N) God; the name used for God in Hebrew scriptures, and used for the Father by Latter-day Saints.; The extraterrestrial creators of humans; the Raelian gods.
eloign: (v) To remove (something) to a distance.; To remove (oneself); to retire, move away (from).
elope: (v) To run away from home with a paramour.; To run away secretly for the purpose of getting married with one's intended spouse; to marry in a quick or private fashion, especially without a public period of engagement.; To run away from home (for any reason).
eloped: (v) simple past tense and past participle of elope
els: (n) plural of el(aj) Obsolete form of else.
else: (aj) Other; in addition to previously mentioned items.(av) Otherwise, if not.(c) For otherwise; or else.
Else: (N) A surname.
elude: (v) To evade or escape from (someone or something), especially by using cunning or skill.; To shake off (a pursuer); to give someone the slip.; To escape being understandable to; to be incomprehensible to.; To escape so.'s memory, to slip so.'s mind.
eluded: (v) simple past tense and past participle of elude
eludes: (v) Third-person singular simple present indicative form of elude
Elul: (N) The twelfth month of the civil year in the Jewish calendar, after Av and before Tishrei.
elute: (v) To separate one substance from another by means of a solvent; to wash; to cleanse.
elver: (n) A young eel.
elves: (n) plural of elf; plural of elve
elvish: (aj) Of or having to do with elves; elven.
Elvish: (N) The language spoken by elves.
elvishes: (n) plural of elvish
Ely: (N) A cathedral city and civil parish (served by City of Ely Council) in East Cambridgeshire district, Cambridgeshire, England.; A suburb of Cardiff, Wales (OS grid ref ST1376).; A river in Rhondda Cynon Taf county borough, Vale of Glamorgan county borough and Cardiff, Wales, which flows into the Severn Estuary.; A city in Iowa; A city in Minnesota; A city, the county seat of White Pine County, Nevada.; An unincorporated community in Virginia; A male given name; A surname.
em: (n) The name of the Latin-script letter M.; A unit of measurement equal to the height of the type in use.(d) Alternative form of 'em(P) A gender-neutral third-person singular object pronoun, the objective case of ey, equivalent to the singular them and coordinate with him and her.(i) a form of hesitant speech, or an expression of uncertainty; um; umm; erm
Em: (N) A diminutive of the female given names Emily and Emma.; Short for Eminem.
embalm: (v) To treat a corpse with preservatives in order to prevent decomposition.; To preserve.; To perfume or add fragrance to something.
embank: (v) to throw up a bank so as to confine or to defend; to protect by a bank of earth or stone
embark: (v) To get on a boat or ship or (outside the USA) an aeroplane.; To start, begin.; To cause to go on board a vessel or boat; to put on shipboard.; To engage, enlist, or invest (as persons, money, etc.) in any affair.
embay: (v) To bathe; to steep.(v) To shut in, enclose, shelter or trap, such as ships in a bay.
embed: (v) To lay as in a bed; to lay in surrounding matter; to bed.; To include in surrounding matter.; To encapsulate within another document or data file.; To define a one-to-one function from one set to another so that certain properties of the domain are preserved when considering the image as a subset of the codomain.(n) An embedded reporter or journalist, such as a war reporter assigned to and travelling with a military unit, or a political reporter assigned to follow and report on the campaign of a candidate.; An element of an advertisement, etc. serving as a subliminal message.; An item embedded in another document.
ember: (n) A glowing piece of coal or wood; a hot coal.; Smoldering ash.(aj) Making a circuit of the year or the seasons; recurring in each quarter of the year, as certain religious days set apart for fasting and prayer.
Ember: (N) A unisex given name.
embers: (n) plural of ember(n) The smoldering or glowing remains of a fire, smoldering ash.
emblem: (n) A representative symbol, such as a trademark or logo.; Something that represents a larger whole.; Inlay; inlaid or mosaic work; something ornamental inserted in a surface.; A picture accompanied with a motto, a set of verses, etc. intended as a moral lesson or meditation.(v) To symbolize.
embody: (v) To represent in a physical or concrete form; to incarnate or personify.; To represent in some other form, such as a code of laws.; To comprise or include as part of a cohesive whole; to be made up of.; To unite in a body or mass.
emboly: (n) embolic invagination
emboss: (v) To mark or decorate with a raised design or symbol, extrude.; To raise in relief from a surface, as an ornament, a head on a coin, etc.(v) Of a hunted animal: to take shelter in a wood or forest.; To drive (an animal) to extremity; to exhaust, to make foam at the mouth.; To hide or conceal in a thicket; to imbosk; to enclose, shelter, or shroud in a wood.; To surround; to ensheath; to immerse; to beset.
embow: (v) To bend like a bow; to curve.
embrue: (v) Alternative form of imbrue
embryo: (n) In the reproductive cycle, the stage after the fertilization of the egg that precedes the development into a fetus.; An organism in the earlier stages of development before it emerges from the egg, or before metamorphosis.; In viviparous animals, the young animal's earliest stages in the mother's body; In humans, usually the cell growth up to the end of the seventh week in the mother's body; A rudimentary plant contained in the seed.; The beginning; the first stage of anything.
embus: (v) to put (troops) onto a bus; to board a bus
embused: (v) plural of embus
embuses: (v) plural of embus
embusing: (v) plural of embus
emcee: (n) Alternative form of MC in its senses as; Master of ceremonies.; Alternative form of MC in its senses as; A rapper.(v) To act as the master of ceremonies (for).; To rap as part of a hip-hop performance.
Emden: (N) An independent city in Lower Saxony, Germany(n) A German breed of domestic goose.
emend: (v) To correct and revise (text or a document).
emerge: (v) To come into view.; To come out of a situation, object or a liquid.; To become known.(n) Alternative spelling of emerg
emery: (n) An impure type of corundum, often used for sanding or polishing.(v) To sand or polish with emery.; To coat with emery.
Emery: (N) A surname, from given names.; A male given name from the Germanic languages, today often transferred back from the surname.; A female given name transferred from the surname, of 2000s usage, also associated with the mineral emery.; A city in South Dakota.; A town in Utah.; A town in Wisconsin.
emesis: (n) The act or process of vomiting.
emesises: (n) plural of emesis
emetic: (aj) Causing nausea and vomiting.(n) An agent that induces vomiting.
emf: (n) Alternative letter-case form of EMF ("electromotive force")
emir: (n) A prince, commander or other leader or ruler in an Islamic nation.; A descendant of the prophet Muhammad.
emit: (v) to send out or give off
emits: (v) Third-person singular simple present indicative form of emit
emmer: (n) A species of wheat, Triticum dicoccon, one of a group of hulled wheats that are important food grains.
emmet: (n) An ant.; A tourist.
Emmet: (N) A surname.; A male given name transferred from the surname.; A ghost town in Queensland, Australia.; A city in Nevada and Hempstead, Arkansas.; A village in Holt County, Nebraska.; An unincorporated community in McLean County, North Dakota.; A ghost town in Union County, South Dakota.; A town in Dodge County, Wisconsin.; A town in Marathon County, Wisconsin.
Emmy: (N) A diminutive of Emily and Emma, also used as a female given name.(n) An award given for artistic excellence in television productions.
emote: (v) To display or express (emotions, mental states, etc.) openly, particularly while acting, and especially in an excessive manner.; To deliver (a speech), say (lines of a play, words), etc., in a dramatic or emotional manner, especially if overly so.; To display (excessive) emotion, especially while acting.; To express a virtual action, presented to other users as a graphic or reported speech, rather than sending a straightforward message.(n) A virtual action expressed to other users as a graphic or reported speech rather than a straightforward message.; Short for emoticon.
empale: (v) Obsolete form of impale.; To make pale.
empery: (n) An empire; the status or dominion of an emperor.; Absolute power or authority.
empire: (n) A political unit, typically having an extensive territory or comprising a number of territories or nations (especially one comprising one or more kingdoms) and ruled by a single supreme authority.; A political unit ruled by an emperor or empress.; A group of states or other territories that owe allegiance to a foreign power.; An expansive and powerful enterprise under the control of one person or group.; control, dominion, sway.(aj) Alternative letter-case form of Empire.
Empire: (aj) Following or imitating a style popular during the First French Empire (1804–1814).; Having the waistline just below the bust; featuring an empire waist.; Produced in a dependency of the British Empire or Commonwealth of Nations.(N) A census-designated place in Stanislaus County, California, United States.; A census-designated place in Washoe County, Nevada, United States.
employ: (n) The state of being an employee; employment.; The act of employing someone or making use of something; employment.; Occupation.(v) To hire (somebody for work or a job).; To use (somebody for a job, or something for a task).; To make busy.
Empson: (N) A surname, from given names.
emptor: (n) Buyer.
empty: (aj) Devoid of content; containing nothing or nobody; vacant.; Containing no elements (as of a string, array, or set), opposed to being null (having no valid value).; Free; clear; devoid; often with of.; Having nothing to carry, emptyhanded; unburdened.; Destitute of effect, sincerity, or sense; said of language.; Unable to satisfy; hollow; vain.; Destitute of reality, or real existence; unsubstantial.; Destitute of, or lacking, sense, knowledge, or courtesy.; Not pregnant; not producing offspring when expected to do so during the breeding season.; Producing nothing; unfruitful.(v) To make empty; to void; to remove the contents of.; Of a river, duct, etc: to drain or flow toward an ultimate destination.(n) A container, especially a bottle, whose contents have been used up, leaving it empty.
emu: (n) A cassowary (genus Casuarius).; A large flightless bird native to Australia, Dromaius novaehollandiae.(n) Clipping of emulator.
emus: (n) plural of emu
en: (n) The name of the Latin-script letter N.; A unit of measurement equal to half an em (half the height of the type in use).(p) Used in various phrases borrowed from French or formed as if borrowed from French (see "Derived terms" below).(P) him; it (when the thing being referred to is masculine)
EN: (N) The Nicomachean Ethics, Aristotle's best-known work on ethics.
enable: (v) To make somebody able (to do, or to be, something); to give sufficient ability or power to do or to be; to give strength or ability to.; To affirm; to make firm and strong.; To qualify or approve for some role or position; to render sanction or authorization to; to confirm suitability for.; To yield the opportunity or provide the possibility for something; to provide with means, opportunities, and the like.; To imply or tacitly confer excuse for an action or a behavior.; To put a circuit element into action by supplying a suitable input pulse.; To activate, to make operational (especially of a function of an electronic or mechanical device).
enact: (v) to make (a bill) into law; to act the part of; to play; to do; to effect(n) purpose; determination
enamel: (n) An opaque, glassy coating baked onto metal or ceramic objects.; A coating that dries to a hard, glossy finish.; The hard covering on the exposed part of a tooth.; A cosmetic intended to give the appearance of a smooth and beautiful complexion.(v) To coat or decorate with enamel.; To variegate with colours, as if with enamel.; To form a glossy surface like enamel upon.; To disguise with cosmetics, as a woman's complexion.
enamor: (v) To cause to be in love.; To captivate.
enate: (n) A relative whose relation is traced only through female members of the family.; Any maternal female relative.(aj) Related to someone by female connections.; Related on the maternal side of the family.; Having identical grammatical structure (but with elements that are semantically different).; Growing out.
encage: (v) To lock inside a cage; to imprison.
encamp: (v) To establish a camp or temporary shelter.; To form into a camp.
encase: (v) To enclose, as in a case.
encode: (v) To convert (plain text) into code.; To convert source information into another form.; To constitute the code necessary for the biosynthesis of a protein by means of a matrix so as to transcribe DNA material.
encore: (av) In addition to what has been said; furthermore; additionally.(n) A brief extra performance, done after the main performance is complete.; A call or demand (as by continued applause) for a repeat performance.(i) Please perform again!(v) To call for an extra performance or repetition of, or by.; To call for an encore.; To perform an encore.
encyst: (v) To enclose within a cyst.; To be enclosed within a cyst.
end: (n) The terminal point of something in space or time.; The cessation of an effort, activity, state, or motion.; Death.; The most extreme point of an object, especially one that is longer than it is wide.; Result.; A purpose, goal, or aim.; One of the two parts of the ground used as a descriptive name for half of the ground.; The position at the end of either the offensive or defensive line, a tight end, a split end, a defensive end.; A period of play in which each team throws eight rocks, two per player, in alternating fashion.; An ideal point of a graph or other complex.; That which is left; a remnant; a fragment; a scrap.; One of the yarns of the worsted warp in a Brussels carpet.; Money.(v) to come to an end; To finish, terminate.
End: (n) A key that when pressed causes the cursor to go to the last character of the current line.
endear: (v) To make (something) more precious or valuable.; To make (something) more expensive; to increase the cost of.; To stress (something) as important; to exaggerate.; To make (someone) dear or precious.
ended: (v) simple past tense and past participle of end(aj) Having (a specified kind or number of) ends.
ending: (n) A termination or conclusion.; The last part of something.; The last morpheme of a word, added to some base to make an inflected form (such as -s in "dogs").(v) present participle of end
endive: (n) A leafy salad vegetable, Cichorium endivia, which is often confused with common chicory (Cichorium intybus).
endow: (v) To provide with a dower (“the portion that a widow receives from her deceased husband's property”) or a dowry (“property given to a bride”).; To give property to (someone) as a gift; specifically, to provide (a person or institution) with support in the form of a permanent fund of money or other benefits.; Followed by with, or rarely by of: to enrich or furnish with some faculty or quality.; Usually in the passive: to naturally furnish (with something).
endows: (v) Third-person singular simple present indicative form of endow
endrin: (n) A toxic chlorinated polycyclic epoxide previously used as a pesticide and now considered a persistent organic pollutant.
endrins: (n) plural of endrin
ends: (n) plural of end(n) The area in close proximity to one's home; neighbourhood.; Money.(v) Third-person singular simple present indicative form of end
Ends: (n) plural of End
endue: (v) To pass food into the stomach; to digest; also figuratively, to take on, absorb.; To take on, to take the form of.; To put on (a piece of clothing); to clothe (someone with something).; To invest (someone) with a given quality, property etc.; to endow.
endued: (v) simple past tense and past participle of endue
endure: (v) To continue or carry on, despite obstacles or hardships; to persist.; To tolerate or put up with something unpleasant.; To last.; To remain firm, as under trial or suffering; to suffer patiently or without yielding; to bear up under adversity; to hold out.; To suffer patiently.; To indurate.
enema: (n) An injection of fluid into the large intestine by way of the rectum, usually for medical purposes.; The fluid so injected.; A device for administering such an injection.
enemy: (n) Someone who is hostile to, feels hatred towards, opposes the interests of, or intends injury to someone else.; A hostile force or nation; a fighting member of such a force or nation.; Something harmful or threatening to another; Of, by, relating to, or belonging to an enemy.; A non-player character that tries to harm the player.(v) To make an enemy of.
energy: (n) The impetus behind all motion and all activity.; The capacity to do work.; A quantity that denotes the ability to do work and is measured in a unit dimensioned in mass × distance²/time² (ML²/T²) or the equivalent.; An intangible, modifiable force (often characterized as either 'positive' or 'negative') believed in some New Age religions to emanate from a person, place or thing and which is (or can be) preserved and transferred in human interactions; shared mood or group habit; a vibe, a feeling, an impression. (Compare aura.); The external actions and influences resulting from an entity’s internal nature (ousia) and by which it is made manifest, as opposed to that internal nature itself; the aspect of an entity that can affect the wider world and be apprehended by other beings.; A measure of how many actions a player or unit can take; in the fantasy genre often called magic points or mana.
enface: (v) To write or print on the face of (a draft, bill, etc.).(aj) For a section of tissue: cut tangentially to an area of interest.
enfold: (v) To fold something around; to envelop; To embrace
eng: (aj) Narrow.(n) Roman alphabet ŋ: The Latin-based letter formed by combining the letters n and g, used in the IPA, Saami, Mende, and some Australian aboriginal languages. In the IPA, it represents the voiced velar nasal, the ng sound in running and rink.
engage: (v) To interact socially.; To engross or hold the attention of; to keep busy or occupied.; To interact socially.; To draw into conversation.; To interact socially.; To attract, to please; (archaic) to fascinate or win over (someone).; To interact antagonistically.; To enter into conflict with (an enemy).; To interact antagonistically.; To enter into battle.; To interact contractually.; To arrange to employ or use (a worker, a space, etc.).; To interact contractually.; To guarantee or promise (to do something).; To interact contractually.; To bind through legal or moral obligation (to do something, especially to marry) (usually in passive).; To interact contractually.; To pledge, pawn (one's property); to put (something) at risk or on the line; to mortgage (houses, land).; To interact mechanically.; To mesh or interlock (of machinery, especially a clutch).; To interact mechanically.; To come into gear with.; To enter into (an activity), to participate (construed with in).; To entangle.
engine: (n) A large construction used in warfare, such as a battering ram, catapult etc.; A tool; a utensil or implement.; A complex mechanical device which converts energy into useful motion or physical effects.; A person or group of people which influence a larger group; a driving force.; The part of a car or other vehicle which provides the force for motion, now especially one powered by internal combustion.; A self-powered vehicle, especially a locomotive, used for pulling cars along a track.; A software or hardware system responsible for a specific technical task (usually with qualifying word).; Ingenuity; cunning, trickery, guile.; The result of cunning; something ingenious, a contrivance; (in negative senses) a plot, a scheme.; Natural talent; genius.; Anything used to effect a purpose; any device or contrivance; an agent.(v) To equip with an engine; said especially of steam vessels.; To assault with an engine.; To contrive; to put into action.; To rack; to torture.
engird: (v) To gird around; to ingirt.
englut: (v) To swallow; to swallow up, engulf.; To glut, satiate.
engobe: (n) A non-black clay slip coating applied to a ceramic body to give it decorative color or improved texture.; A clay slip which is colored with metal oxides or stains, used for coating the surface of a pot either before or after bisque firing.
engram: (n) A postulated physical or biochemical change in neural tissue that represents a memory.; A painful, negative mental image representing a past event.
Engram: (N) A surname, from given names, a rare variant of Ingram.; an enneagram, a nine-pointed figure.; N-gram, a subsequence.
engulf: (v) To overwhelm.; To surround; to cover; to submerge.; To cast into a gulf.
enid: (n) Any snail in the family Enidae.
Enid: (N) A female given name from Welsh of Welsh origin and obscure meaning.; A city, the county seat of Garfield County, Oklahoma, United States; see Wikipedia:Enid, Oklahoma
enigma: (n) Something or someone puzzling, mysterious or inexplicable.; A riddle, or a difficult problem.
Enigma: (N) A German device used during World War II to encode strategic messages.
enisle: (v) To make into an island.; To isolate.
enjoin: (v) To lay upon, as an order or command; to give an injunction to; to direct with authority; to order; to charge.; To prohibit or restrain by a judicial order or decree; to put an injunction on.
enjoy: (v) To receive pleasure or satisfaction from something.; To have the use or benefit of something.; To be satisfied or receive pleasure.; To have sexual intercourse with.
enjoys: (v) Third-person singular simple present indicative form of enjoy
enlace: (v) To bind or encircle with lace, or as with lace; To entangle.
enlist: (v) To enter on a list; to enroll; to register.; To voluntarily join a cause or organization, especially military service.; To recruit the aid or membership of others.; To secure; to obtain.(n) One who is enlisted, usually in a military service.
enmesh: (v) To mesh; to tangle or interweave in such a manner as not to be easily separated, particularly in a mesh or net like manner.; To involve in such complications as to render extrication difficult; To involve in difficulties.
enmity: (n) The quality of being an enemy; hostile or unfriendly disposition.; A state or feeling of opposition, hostility, hatred or animosity.
ennead: (n) The number nine.; Any grouping or system containing nine objects.
Ennead: (N) The collection of nine gods worshipped at Heliopolis and taking part in the Heliopolitan creation myth, together representing the sum of all the elements of the created world: Atum, Shu, Tefnut, Nut, Geb, Osiris, Isis, Set, and Nephthys.(n) One of the six parts of the writings of the Greek-speaking philosopher Plotinus (c. 204–205 – 270), each containing nine treatises, compiled by his student Porphyry (c. 234 – c. 305).
ennui: (n) A gripping listlessness or melancholia caused by boredom; depression.(v) To make bored or listless; to weary.
ennuis: (n) plural of ennui(v) Third-person singular simple present indicative form of ennui
enoch: (n) an iron sledgehammer
Enoch: (N) In the Bible, one of the few people recorded as being taken by God before death.; The title of three apocryphal books of the Bible.; First son of Cain.; A male given name from Hebrew of biblical origin.; A First Nation reserve in Alberta, Canada; the postal name of Stony Plain Indian Reserve No. 135.
enol: (n) An organic compound containing a hydroxyl group bonded to a carbon atom which is doubly bonded to another carbon atom.
Enos: (N) A grandson of Adam.; A male given name from Hebrew of biblical origin.; A surname of uncertain origin.
Enosis: (N) Any political movement aiming to incorporate Greek-populated areas currently outside Greece into Greece.; A political movement aiming to incorporate the island of Cyprus into Greece.
Enosises: (n) plural Enosis
enough: (d) Sufficient; all that is required, needed, or appropriate.(av) Sufficiently.; Fully; quite; used after adjectives to express slight augmentation of the positive degree, and sometimes equivalent to very.; Used after certain adverbs to emphasise that a quality is notable, unexpected, etc.(P) A sufficient or adequate number, amount, etc.(i) Stop! Don't do that any more!(n) An instance of being sufficient, or of doing something sufficiently.
enow: (d) Archaic form of enough.(av) Archaic form of enough.(av) Just now.; Soon.
enows: (n) plural of enow
enrage: (v) To become angry or wild.; To fill with rage; to provoke to frenzy; to make furious.; To provoke to madness, to make insane.
enrich: (v) To enhance.; To make (someone or something) rich or richer.; To adorn, ornate more richly.; To add nutrients or fertilizer to the soil; to fertilize.; To increase the amount of one isotope in a mixture of isotopes, especially in a nuclear fuel.; To add nutrients to foodstuffs; to fortify.; To make to rise the proportion of a given constituent.
enrobe: (v) To invest or adorn with a robe or vestment; to attire.; To coat or cover.
enrol: (v) Standard spelling of enroll.
enroll: (v) To enter (a name, etc.) in a register, roll or list; To enlist (someone) or make (someone) a member of; To enlist oneself (in something) or become a member (of something); To envelop; to enwrap.
enroot: (v) To take root.; To fix by the root; to implant firmly.
ens: (n) An entity or being; an existing thing, as opposed to a quality or attribute.; Something supposed to condense within itself all the virtues and qualities of a substance from which it is extracted; an essence, an active principle.(n) plural of en
ensign: (n) A badge of office, rank, or power.; The lowest grade of commissioned officer in the United States Navy, junior to a lieutenant junior grade.; A flag or banner carried by military units; a standard or color/colour.; The principal flag or banner flown by a ship (usually at the stern) to indicate nationality.; Any prominent flag or banner.; A junior commissioned officer in the 18th and 19th centuries whose duty was to carry the unit's ensign.(v) To designate as by an ensign.; To distinguish by a mark or ornament.; To distinguish by an ornament, especially by a crown.
Ensign: (N) A surname.; A hamlet in Alberta, Canada; A city in Kansas; The official magazine of The Church of Jesus Christ of Latter-day Saints
ensile: (v) To preserve (forage) in a silo.
ensoul: (v) To give a soul or place in the soul.
ensue: (v) To follow (a leader, inclination etc.).; To follow (in time), to be subsequent to.; To occur afterwards, as a result or effect.
ensued: (v) simple past tense and past participle of ensue
ensues: (v) Third-person singular simple present indicative form of ensue
ensure: (v) To make a pledge to (someone); to promise, guarantee (someone of something); to assure.; To make sure or certain of something (usually some future event or condition).
entail: (v) To imply or require.; To settle or fix inalienably on a person or thing, or on a person and his descendants or a certain line of descendants; -- said especially of an estate; to bestow as a heritage.; To appoint hereditary possessor.; To cut or carve in an ornamental way.(n) That which is entailed. Hence:; An estate in fee entailed, or limited in descent to a particular class of issue.; That which is entailed. Hence:; The rule by which the descent is fixed.; Delicately carved ornamental work; intaglio.
enter: (v) To go or come into an enclosed or partially enclosed space.; To cause to go (into), or to be received (into); to put in; to insert; to cause to be admitted.; To go or come into (a state or profession).; To type (something) into a computer; to input.; To record (something) in an account, ledger, etc.; To become a party to an agreement, treaty, etc.; To become effective; to come into effect.; To go into or upon, as lands, and take actual possession of them.; To place in regular form before the court, usually in writing; to put upon record in proper from and order; To make report of (a vessel or its cargo) at the custom house; to submit a statement of (imported goods), with the original invoices, to the proper customs officer for estimating the duties. See entry.; To file, or register with the land office, the required particulars concerning (a quantity of public land) in order to entitle a person to a right of preemption.; To deposit for copyright the title or description of (a book, picture, map, etc.).; To initiate; to introduce favourably.(n) Alternative spelling of Enter (“the computer key”); Alternative spelling of Enter (“a stroke of the computer key”)
Enter: (n) The "Enter" key on a computer keyboard.; A stroke of the Enter key.
enters: (v) Third-person singular simple present indicative form of enter(n) plural of enter
Enters: (n) plural of Enter
entice: (v) To lure; to attract by arousing desire or hope.
entire: (aj) Whole; complete.; Having a smooth margin without any indentation.; Consisting of a single piece, as a corolla.; Complex-differentiable on all of ℂ.; Not gelded.; morally whole; pure; sheer; Internal; interior.(n) The whole of something; the entirety.; An uncastrated horse; a stallion.; A complete envelope with stamps and all official markings: (prior to the use of envelopes) a page folded and posted.; Porter or stout as delivered from the brewery.
entity: (n) That which has a distinct existence as an individual unit. Often used for organisations which have no physical form.; The existence of something considered apart from its properties.; Anything about which information or data can be stored in a database; in particular, an organised array or set of individual elements or parts.; The state or quality of being or existence.; A spirit, ghost, or the like.; An alien lifeform that has no corporeal body.
entoil: (v) To capture with toils or nets; to ensnare.
entomb: (v) To deposit in a tomb.; To confine in restrictive surroundings.
entrap: (v) To catch in a trap or snare.; To lure (someone), either into a dangerous situation, or into performing an illegal act.
entree: (n) Alternative form of entrée
entry: (n) The act of entering.; Permission to enter.; A doorway that provides a means of entering a building.; The act of taking possession.; The start of an insurance contract.; A passageway between terraced houses that provides a means of entering a back garden or yard.; A small room immediately inside the front door of a house or other building, often having an access to a stairway and leading on to other rooms; A small group formed within a church, especially Episcopal, for simple dinner and fellowship, and to help facilitate new friendships; An item in a list, such as an article in a dictionary or encyclopedia.; A record made in a log, diary or anything similarly organized; (computing) a datum in a database.; A term at any position in a matrix.; The exhibition or depositing of a ship's papers at the customhouse, to procure licence to land goods; or the giving an account of a ship's cargo to the officer of the customs, and obtaining his permission to land the goods.; The point when a musician starts to play or sing; entrance.; The introduction of new hounds into a pack.
enure: (v) To inure; to make accustomed or desensitized to something unpleasant due to constant exposure.; To take effect, to be operative; used with to.
envied: (v) simple past tense and past participle of envy(aj) That is the object of envy.(v) simple past tense and past participle of envie
envies: (n) plural of envy(v) Third-person singular simple present indicative form of envy
envoi: (n) A short stanza at the end of a poem, used either to address a person or to comment on the preceding body of the poem.
envoy: (n) a diplomatic agent of the second rank, next in status after an ambassador.; a representative.; a diplomat.; a messenger.; Alternative spelling of envoi: a short stanza at the end of a poem
envoys: (n) plural of envoy
envy: (n) Resentful desire of something possessed by another or others (but not limited to material possessions).; An object of envious notice or feeling.; Hatred, enmity, ill-feeling.; Emulation; rivalry.; Public odium; ill repute.(v) To feel displeasure or hatred towards (someone) for their good fortune or possessions.; To have envious feelings (at).; To give (something) to (someone) grudgingly or reluctantly; to begrudge.; To show malice or ill will; to rail.; To do harm to; to injure; to disparage.; To hate.; To emulate.
enwind: (v) To wind about; to encircle.
enwomb: (v) To place or cause to be contained in the womb; to make pregnant; to conceive.; To enclose.
enwrap: (v) To wrap around, surround; to envelop; To absorb completely or engross
enzyme: (n) A globular protein that catalyses a biological chemical reaction.; leavened bread, as opposed to azyme
Eo: (N) A river in northern Spain, whose estuary marks part of the border between Galicia and Asturias
Eocene: (aj) of a geologic epoch within the Paleogene period from about 56 to 34 million years ago.(N) the Eocene epoch
eolian: (aj) Alternative spelling of aeolian
Eolian: (aj) Alternative spelling of Aeolian
eolic: (aj) Of the wind; referring to the action or the power of wind.
eolith: (n) Crudely chopped flints, believed to be naturally produced by geological processes such as glaciation.
eon: (n) Eternity.; A period of 1,000,000,000 years.; The longest time period used in geology.; A long period of time.; A spirit being emanating from the Godhead.
EON: (N) The Greek National Organisation of Youth, similar to the Hitler Youth. It was formed before WWII and disbanded in 1941.
eonian: (aj) Of or pertaining to an eon; everlasting
eonism: (n) The pretence of being the opposite sex, especially that by a man of being a woman; transvestism.
eonisms: (n) plural of eonism
eosin: (n) A red, acidic dye commonly used in histological stains.
epact: (n) the time (number of days) by which a solar year exceeds twelve lunar months; it is used in the calculation of the date of Easter
eparch: (n) The governor or prefect of a province.; The ruler of an eparchy.; The metropolitan bishop of a province or eparchy.
ephah: (n) A former Hebrew unit of dry volume (about 23 L).
ephebe: (n) A 18- to 20-year-old man in ancient Greece undergoing military training.; A young man; a youth.
ephod: (n) A priestly apron, or breastplate, described in the Bible in Exodus 28: vi - xxx, which only the chief priest of ancient Israel was allowed to wear.
ephor: (n) One of the five annually-elected senior magistrates in various Dorian states, especially in ancient Sparta, where they oversaw the actions of Spartan kings.; A superintendent or curator.
ephori: (n) plural of ephor
epic: (n) An extended narrative poem in elevated or dignified language, celebrating the feats of a deity, demigod (heroic epic), other legend or traditional hero.; A series of events considered appropriate to an epic.; In software development, a large or extended user story.(aj) Of or relating to an epic.; Momentously heroic; grand in scale or character; Extending beyond the usual or ordinary.(aj) That is an epimorphism.
Epic: (aj) Alternative letter-case form of epic(n) Alternative letter-case form of epic
epics: (n) plural of epic
epoch: (n) A particular period of history, or of a person's life, especially one considered noteworthy or remarkable.; A notable event which marks the beginning of such a period.; A precise instant of time that is used as a point of reference.; A precise instant of time that is used as a point of reference (e.g., January 1, 1970, 00:00:00 UTC).; One complete presentation of the training data set to an iterative machine learning algorithm; generation.; A unit of geologic time subdividing a period into smaller parts.(v) To divide (data) into segments by time period.
epochs: (n) plural of epoch
epode: (n) The after song; the part of a lyric ode which follows the strophe and antistrophe.; A kind of lyric poem, invented by Archilochus, in which a longer verse is followed by a shorter one.
eponym: (n) A real or fictitious person's name that has given rise to the name of a particular item.; A word formed from a real or fictive person’s name.; A word formed from a real or fictive place or thing.
epos: (n) An epic.
epoxy: (aj) Derived from an epoxide.(n) A thermosetting polyepoxide resin used chiefly in strong adhesives, coatings and laminates; epoxy resin.(v) To glue with epoxy.
Epsom: (N) A town in Surrey, England, known for its racecourse.; A suburb of Auckland, New Zealand.
equal: (aj) The same in all respects.; Exactly identical, having the same value.; Fair, impartial.; Adequate; sufficiently capable or qualified.; Not variable; equable; uniform; even.; Intended for voices of one kind only, either all male or all female; not mixed.(v) To be equal to, to have the same value as; to correspond to.; To make equivalent to; to cause to match.; To have as its consequence.(n) A person or thing of equal status to others.; State of being equal; equality.
equals: (n) plural of equal(n) The symbol =(v) Third-person singular simple present indicative form of equal
equate: (v) To consider equal or equivalent.; To set as equal.(n) A statement in assembly language that defines a symbol having a particular value.
equine: (aj) Of or relating to a horse or horses.; Of or relating to any member or members of the genus Equus.(n) Any horse or horse-like animal, especially one of the genus Equus.
equip: (v) To supply with something necessary in order to carry out a specific action or task; to provide with (e.g. weapons, provisions, munitions, rigging); To dress up; to array; to clothe.; To prepare (someone) with a skill.; To equip oneself with (an item); to bring (equipment) into active use.
equity: (n) Fairness, impartiality, or justice as determined in light of "natural law" or "natural right".; Various related senses originating with the Court of Chancery in late Medieval England; The power of a court of law having extra-statutory discretion, to decide legal matters and to provide legal relief apart from, though not in violation of, the prevailing legal code; in some cases, a court "sitting in equity" may provide relief to a complainant should the code be found either inapplicable or insufficient to do so.; Various related senses originating with the Court of Chancery in late Medieval England; A right which accrues to a party in a transaction because of the nature of the transaction itself, and which is exercisable upon a change of circumstances or conditions; in other words, an equitable claim.; Various related senses originating with the Court of Chancery in late Medieval England; The body of law which was developed in the English Court of Chancery, which Court had extra-statutory discretion, and is now administered alongside the common law of Britain.; Various senses related to net value; Value of property minus liens or other encumbrances.; Various senses related to net value; Ownership, especially in terms of net monetary value of some business.; Various senses related to net value; Ownership interest in a company as determined by subtracting liabilities from assets.; Various senses related to net value; A player's expected share of the pot.; Equality
er: (i) Said when hesitating in speech.(v) To utter the word "er" when hesitating in speech, found in the phrase um and er.
ER: (n) The statistic "Earned Run" (a run that was scored without the aid of an error by the fielding team that is charged to the pitcher responsible for allowing the runner that scored to reach base.)
era: (n) A time period of indeterminate length, generally more than one year.; A unit of time, smaller than eons and greater than periods.
eras: (n) plural of era
erase: (v) to remove markings or information; To obliterate information from (a storage medium), such as to clear or (with magnetic storage) to demagnetize.; To obliterate (information) from a storage medium, such as to clear or to overwrite.; To remove a runner from the bases via a double play or pick off play; To be erased (have markings removed, have information removed, or be cleared of information).; To disregard (a group, an orientation, etc.); to prevent from having an active role in society.; To kill; assassinate.(n) The operation of deleting data.
erased: (v) simple past tense and past participle of erase(aj) having the appearance of being forcibly torn off, with parts left jagged or uneven.
eraser: (n) One who erases.; A thing used to erase or remove something written or drawn by a pen or a pencil.; A thing used to erase something written by chalk on a chalkboard, by marker on a whiteboard, or by some other erasable implement; a chalkboard eraser, whiteboard eraser, etc.; An overwriter program used to prevent data recovery.
Erato: (N) The goddess of lyric poetry, particularly erotic poetry, eroticism, and mimic imitation, and one of the Muses; the daughters of Zeus & Mnemosyne. Usually depicted with a crown/wreath of myrtle and roses, holding a lyre and a golden arrow and doves. Often accompanies Eros/Cupid.; 62 Erato, a main belt asteroid.
erbium: (n) A chemical element (symbol Er) with atomic number 68: a silvery-white metal, in nature always found in combination with other elements.; A single atom of this element.
ere: (av) At an earlier time.(p) Before; sooner than.(c) Before.(n) Obsolete form of ear.
Ere: (N) A language spoken on Manus Island in Papua New Guinea.
Erebus: (N) One of the Greek primordial deities who was the personification of darkness and shadow, brother-husband of Nyx and son of Chaos.; The dark and gloomy cavern between the earth and Hades; the underworld.; A volcano in Antarctica, named after HMS Erebus.
erect: (aj) Upright; vertical or reaching broadly upwards.; Rigid, firm; standing out perpendicularly, especially as the result of stimulation.; Having an erect penis; Bold; confident; free from depression; undismayed.; Directed upward; raised; uplifted.; Watchful; alert.; Elevated, as the tips of wings, heads of serpents, etc.(v) To put up by the fitting together of materials or parts.; To cause to stand up or out.; To raise and place in an upright or perpendicular position; to set upright; to raise.; To spin up and align to vertical.; To lift up; to elevate; to exalt; to magnify.; To animate; to encourage; to cheer.; To cast or draw up (a figure of the heavens, horoscope etc.).; To enter a state of physiological erection.; To set up as an assertion or consequence from premises, etc.; To set up or establish; to found; to form; to institute.
erects: (v) Third-person singular simple present indicative form of erect
ered: (v) plural of ere
erenow: (av) Before now; prior to this point in time.
Erfurt: (N) The capital city of Thuringia, Germany.
erg: (n) The unit of work or energy, being the amount of work done by a force of one dyne applied through a distance of one centimeter. Equal to 10⁻⁷ joules.(n) A large desert region of sand dunes with little or no vegetation, especially in the Sahara.(n) An ergometer.(v) To use an ergometer.
ergo: (av) Consequently, therefore, or thus.(c) therefore (especially in syllogisms)(n) An ergometer (rowing machine).(n) An ergonomic factor or characteristic.
ergot: (n) Any fungus in the genus Claviceps which are parasitic on grasses.; The sclerotium (wintering stage) of certain fungi in the genus Claviceps, appearing as a deformed grain in certain cereals and grasses infected by the fungi.
Erie: (n) A tribe of Native Americans.(N) One of the Great Lakes of North America.; A small city, the county seat of Neosho County, Kansas, United States.; A city, the county seat of Erie County, Pennsylvania, United States.; Any of a number of other places in North America; see Erie (disambiguation) at Wikipedia.
Erin: (N) Ireland.; A locale in North America; named in honor of Ireland.; A town in Ontario.; A locale in North America; named in honor of Ireland.; A town in Wisconsin.; A locale in North America; named in honor of Ireland.; A town in New York.; A locale in North America; named in honor of Ireland.; A city, the county seat of Houston County, Tennessee.; A locale in North America; named in honor of Ireland.; An unincorporated community in Texas.; A female or male given name, in use since the mid-20th century, used in honor of Ireland.
ering: (v) plural of ere
eringo: (n) Alternative form of eryngo
erk: (n) A member of the groundcrew in the RAF.(i) An expression of trepidation; eek.; An expression of revulsion or disgust; yuck.
ermine: (n) A weasel found in northern latitudes (Mustela erminea in Eurasia, Alaska, and the Arctic, Mustela haidarum in Haida Gwaii, Mustela richardsonii in the rest of North America); its dark brown fur turns white in winter, apart from the black tip of the tail.; The white fur of this animal, traditionally seen as a symbol of purity and used for judges' robes.; The office of a judge.; A white field with black spots.; Any of various moths, especially in the family Yponomeutidae(v) To clothe with ermine.
erne: (n) A sea eagle (Haliaeetus), especially the white-tailed eagle (Haliaeetus albicilla); An eagle.(v) To long; to yearn.
Erne: (N) A river in Ireland and Northern Ireland, starting in County Cavan, entering County Fermanagh, and passing through Upper and Lower Lough Erne on its way to the sea in County Donegal.
Ernst: (N) A surname.
erode: (v) To wear away by abrasion, corrosion or chemical reaction.; To destroy gradually by an ongoing process.
eros: (n) A winged figure of a child representing love and/or its power.; Physical love; sexual desire.; a type of love that seeks fulfillment without violation or something else.; libido; collective instincts for self-preservation; life drive.
Eros: (N) The god of love and sexual desire; son of either Erebus and Nyx or Aphrodite and Ares. His Roman counterpart is Cupid.; 433 Eros, an asteroid
erose: (aj) Irregularly notched, eaten away, as though bitten.
eroses: (n) plural of eros
erotic: (aj) Relating to or tending to arouse sexual desire or excitement.(n) An amorous composition or poem.
err: (v) To make a mistake.; To sin.; to stray.
errand: (n) A journey undertaken to accomplish some task.; A mission or quest.; A journey undertaken to accomplish some task.; A mundane mission of no great consequence, concerning household or business affairs (dropping items by, doing paperwork, going to a friend's house, etc.); The purpose of such a journey.; An oral message trusted to a person for delivery.(v) To send someone on an errand.; To go on an errand.
errant: (aj) Straying from the proper course or standard, or outside established limits.; Roving around; wandering.; Prone to making errors; misbehaving.; Obsolete form of arrant (“complete; downright, utter”).(n) A knight-errant.
erred: (v) simple past tense and past participle of err(v) simple past tense and past participle of er
erring: (v) present participle of err(n) The act of one who errs; sin.(v) present participle of er
error: (n) The state, quality, or condition of being wrong.; A mistake; an accidental wrong action or a false statement not made deliberately.; Sin; transgression.; A failure to complete a task, usually involving a premature termination.; The difference between a measured or calculated value and a true one.; A play which is scored as having been made incorrectly.; One or more mistakes in a trial that could be grounds for review of the judgement.; Any alteration in the DNA chemical structure occurring during DNA replication, recombination or repairing.(v) To function improperly due to an error, especially accompanied by error message.; To show or contain an error or fault.; To err.
errors: (n) plural of error(v) Third-person singular simple present indicative form of error
errs: (v) Third-person singular simple present indicative form of err
ers: (v) Third-person singular simple present indicative form of er
ERs: (n) plural of ER
ersatz: (aj) made in imitation; artificial, especially of a poor quality(n) something made in imitation; an effigy or substitute
Erse: (n) Either of the Gaelic languages of Ireland and Scotland.(aj) Connected with Ireland or the Highlands of Scotland, or to the Gaelic languages spoken in those places.
erses: (n) plural of ers
erst: (aj) First.(av) First of all, before (some other specified thing).; Sooner (than); before.; Formerly, once, erstwhile.
eruct: (v) To burp or belch.
erupt: (v) To eject something violently (such as lava or water, as from a volcano or geyser).; To burst forth; to break out.; To spontaneously release pressure or tension.; (Of birds, insects, etc.) To suddenly appear in a certain region in large numbers.
eryngo: (n) The root of sea holly, Eryngium maritimum, formerly candied and taken as confectionery and held to have aphrodisiac properties.; Any other plant of the same genus, Eryngium.
es: (n) Alternative form of ess (letter 's') in compounds such as "es-hook".(n) Alternative form of e's.(v) Pronunciation spelling of is.
Es: (n) plural of E
Esau: (N) The son of Isaac and Rebekah and the older twin brother of Jacob.; A male given name from Hebrew.; A surname.
escape: (v) To get free; to free oneself.; To avoid (any unpleasant person or thing); to elude, get away from.; To avoid capture; to get away with something, avoid punishment.; To elude the observation or notice of; to not be seen or remembered by.; To cause (a single character, or all such characters in a string) to be interpreted literally, instead of with any special meaning it would usually have in the same context, often by prefixing with another character.; To halt a program or command by pressing a key (such as the "Esc" key) or combination of keys.(n) The act of leaving a dangerous or unpleasant situation.; Leakage or outflow, as of steam or a liquid, or an electric current through defective insulation.; Something that has escaped; an escapee.; A holiday, viewed as time away from the vicissitudes of life.; escape key; The text character represented by 27 (decimal) or 1B (hexadecimal).; A successful shot from a snooker position.; A defective product that is allowed to leave a manufacturing facility.; That which escapes attention or restraint; a mistake, oversight, or transgression.; A sally.; An apophyge.
escarp: (n) The side of the ditch next to the parapet in a fortification; the scarp.(v) To make into, or furnish with, a steep slope, like that of a scarp.
eschar: (n) A superficial structure of dead tissue, usually hardened, commonly, but not necessarily dark, adhering to underlying living or necrotic tissue, caused by gangrene or a burn; Any hard, dark, commonly flattened or sunken lesion or crust, especially on a burn, abscess, infection, wound; commonly a coagulation of blood or exudations, not necessarily involving dead or necrotic tissue.; The emotional imprint of a trauma such as grief, loss, or degradation
eschew: (v) To avoid; to shun, to shy away from.
escort: (n) A group of people or vehicles, generally armed, who go with a person or people of importance to safeguard them on a journey or mission.; An accompanying person in such a group.; A guard who travels with a dangerous person, such as a criminal, for the protection of others.; A group of people attending as a mark of respect or honor.; An accompanying person in a social gathering, etc.; Protection, care, or safeguard on a journey or excursion.; A sex worker who does not operate in a brothel, but with whom clients make appointments; a call girl or male equivalent.(v) To attend to in order to guard and protect; to accompany as a safeguard (for the person escorted or for others); to give honorable or ceremonious attendance to; To accompany (a person) in order to compel them to go somewhere (e.g. to leave a building).; To go with someone as a partner, for example on a formal date.
escrow: (n) A written instrument, such as a deed, temporarily deposited with a neutral third party (the escrow agent), by the agreement of two parties to a valid contract. The escrow agent will deliver the document to the benefited party when the conditions of the contract have been met. The depositor has no control over the instrument in escrow.; In common law, escrow applied to the deposits only of instruments for conveyance of land, but it now applies to all instruments so deposited.; Money or other property so deposited is also loosely referred to as escrow.; The state of property deposited with an escrow agent.(v) To place in escrow.
escudo: (n) The state currency formerly used in Portugal, divided into 100 centavos. The symbol is $ which is positioned between the escudos & centavos, 2$50.; The currency formerly used in Chile and replaced by the Peso.; The current currency of Cape Verde.
Esdras: (N) any of four books of the Old Testament and Apocrypha of the Bible.
esker: (n) A long, narrow, sinuous ridge created by deposits from a stream running beneath a glacier.
Esker: (N) A surname, from German.
Eskimo: (N) A group of indigenous peoples inhabiting the Arctic, from Siberia, through Alaska and Northern Canada, to Greenland, including the Inuit and Yupik.; Any of the languages of the Eskimo.(n) A member of any of the Eskimo peoples.; A dog of the American Eskimo breed.; A team member of the Canadian Football League's Edmonton Eskimos. (Obsolete as of 2020 with the team dropping this name in favour of Elks in 2021.)(aj) Of or relating to the Eskimo peoples.; In, of, or relating to the Eskimo languages.
Espada: (N) A surname.
Espadas: (n) plural Espada
espial: (n) An act of noticing or observing.; The fact of noticing or observing; a discovery.; A scout; a spy.
espied: (v) simple past tense and past participle of espy
esprit: (n) Spirit, enthusiasm.; A wit.; Liveliness, or active mind and spirit.
esprits: (n) plural of esprit
espy: (v) To catch sight of; to see; to spot (said especially of something not easy to see); To examine and keep watch upon; to watch; to observe.; To look or search narrowly; to look about; to watch; to take notice; to spy.
Espy: (N) A surname.; A census-designated place in Columbia County, Pennsylvania, United States.
ess: (n) The name of the Latin-script letter S.; Something shaped like the letter S. (See esses)(v) To move in a changing direction, forming the shape of a letter S.
ESS: (n) evolutionarily stable strategy
essay: (n) A written composition of moderate length, exploring a particular issue or subject.; A test, experiment; an assay.; An attempt.; A proposed design for a postage stamp or a banknote.(v) To try.; To move forth, as into battle.
essays: (n) plural of essay(v) Third-person singular simple present indicative form of essay
esse: (n) Essence, essential nature.
Essen: (N) A major industrial city in North Rhine-Westphalia, in western Germany.; A surname, from German.
Essene: (n) A member of a first-century ascetic Jewish sect in ancient Palestine from the second century BCE to the second century CE. The Essenes are believed to have been the authors of the Dead Sea scrolls.
Essex: (N) A surname.; A maritime county of England bordered by the North Sea, Suffolk, Cambridgeshire, Hertfordshire and Greater London, and separated from Kent by the Thames estuary.; A town in Essex County, Ontario, Canada.; A locality in Humboldt County, California.; A small unincorporated community in San Bernardino County, California.; A town in Middlesex County, Connecticut.; A village in Kankakee County, Illinois.; A city in Page County, Iowa.; An unincorporated community and census-designated place in Baltimore County, Maryland.; A coastal town and census-designated place in Essex County, Massachusetts.; A city in Stoddard County, Missouri.; An unincorporated community in Flathead County, Montana.; A town in Essex County, New York.; An unincorporated community in Halifax County, North Carolina.; An unincorporated community in Union County, Ohio.; A large town in Chittenden County, Vermont.
essive: (aj) of, or relating to the grammatical case that in some languages indicates existence in a state or capacity.; indicating a temporary state of being.(n) the essive case, or a word in that case.
est: (n) Grace; favour.(n) Erhard Seminars Training, a course intended to promote satisfaction with life in the present moment, as opposed to strivings to attain it.
Est: (N) Esther, the book of Esther(aj) established (when followed by a date, often written before (or after) companies' names or brands on their logotypes)
estate: (n) The collective property and liabilities of someone, especially a deceased person.; state; condition.; Status, rank.; The condition of one's fortunes; prosperity, possessions.; A "person of estate"; a nobleman or noblewoman.; A major social class or order of persons regarded collectively as part of the body politic of the country and formerly possessing distinct political rights (Estates of the realm).; The nature and extent of a person's interest in, or ownership of, land.; An (especially extensive) area of land, under a single ownership.; The landed property owned or controlled by a government or a department of government.; A housing estate.; A station wagon; a car with a tailgate (or liftgate) and storage space to the rear of the seating which is coterminous with the passenger compartment (and often extensible into that compartment via folding or removable seating).; The state; the general body politic; the common-wealth; the general interest; state affairs.; An organization's collective information technology resources.(aj) Previously owned; secondhand.(v) To give an estate to.; To bestow upon.
esteem: (n) Favourable regard.(v) To set a high value on; to regard with respect or reverence.; To regard something as valuable; to prize.; To look upon something in a particular way.; To judge; to estimate; to appraise
ester: (n) A compound most often formed by the condensation of an alcohol and an acid, with elimination of water, which contains the functional group carbon-oxygen double bond (i.e., carbonyl) joined via carbon to another oxygen atom.
Ester: (N) A female given name from Hebrew, alternative form of Esther
Esther: (N) A female given name from Persian.; A book of the Old Testament and the Hebrew Tanakh.; The heroine of the Book of Esther.
estop: (v) To impede or bar by estoppel.; To stop up, to plug
estray: (n) An animal that has escaped from its owner; a wandering animal whose owner is unknown. An animal cannot be an estray when on the range where it was raised, and permitted by its owner to run. A lost animal whose owner is known to the party at hand is not an estray.; Stray.(v) To stray.
estrin: (n) Alternative form of oestrin
Estrin: (N) A surname, from Yiddish.
estrus: (n) Alternative spelling of oestrus
et: (v) Pronunciation spelling of ate, the simple past tense and past participle of eat
ET: (n) End transaction, end of transaction (with transaction meaning an amendment in the reservation system in this sense).
eta: (n) The seventh letter of the Modern Greek alphabet, the eighth in Old Greek.; A kind of electrically neutral meson having zero spin and isospin.(n) A social outcast in Japan who is subjected to menial work, making up a class or caste of such people.
etalon: (n) An optical device containing parallel mirrors, used as a narrow band filter, often in laser design.
etch: (v) To cut into a surface with an acid or other corrosive substance in order to make a pattern. Best known as a technique for creating printing plates, but also used for decoration on metal, and, in modern industry, to make circuit boards.; To engrave a surface.; To make a lasting impression.; To sketch; to delineate.(n) Obsolete form of eddish.
etched: (aj) Cut or dug into the surface as by etching.; Toned and with a well-defined musculature.(v) simple past tense and past participle of etch
eterne: (aj) Eternal.
eth: (n) A letter (capital Ð, small ð) introduced into Old English to represent its dental fricative, then not distinguished from the letter thorn, no longer used in English but still in modern use in Icelandic, the IPA and other phonetic alphabets to represent the voiced dental fricative "th" sound as in the English word then. The letter is also used in Faroese, but is generally silent in that language.
Eth: (N) A short form of the female given name Ethel.
ethane: (n) An aliphatic hydrocarbon, C₂H₆, gaseous at normal temperatures and pressures, being a constituent of natural gas.; The same compound, subjected to modification by replacing one or more of the hydrogen atoms with other radicals.
ethene: (n) The organic chemical compound ethylene. The simplest alkene, a colorless gaseous (at room temperature and pressure) hydrocarbon with the chemical formula C₂H₄; Any alkene derived from ethylene
ether: (n) The substance formerly supposed to fill the upper regions of the atmosphere above the clouds, in particular as a medium breathed by deities.; The medium breathed by human beings; the air.; The substance formerly supposed to fill the upper regions of the atmosphere above the clouds, in particular as a medium breathed by deities.; The sky, the heavens; the void, nothingness.; Often as aether and more fully as luminiferous aether: a substance once thought to fill all unoccupied space that allowed electromagnetic waves to pass through it and interact with matter, without exerting any resistance to matter or energy; its existence was disproved by the 1887 Michelson–Morley experiment and the theory of relativity propounded by Albert Einstein (1879–1955).; The atmosphere or space as a medium for broadcasting radio and television signals; also, a notional space through which Internet and other digital communications take place; cyberspace.; A particular quality created by or surrounding an object, person, or place; an atmosphere, an aura.; Diethyl ether (C₄H₁₀O), an organic compound with a sweet odour used in the past as an anaesthetic.; Any of a class of organic compounds containing an oxygen atom bonded to two hydrocarbon groups.(v) To viciously humiliate or insult.(n) Alternative letter-case form of Ether
Ether: (N) The god-personification of the bright, glowing upper air of heaven. He is the Roman counterpart of Aether.; The ancient American prophet of Mormon theology who wrote the Book of Ether in the Book of Mormon.(n) A unit of the Ethereum digital currency, ETH.
ethic: (aj) Moral, relating to morals.(n) A set of principles of right and wrong behaviour guiding, or representative of, a specific culture, society, group, or individual.; The morality of an action.
ethics: (n) The study of principles relating to right and wrong conduct.; Morality.; The standards that govern the conduct of a person, especially a member of a profession.
Ethiop: (n) A native or inhabitant of Ethiopia.; Any black-skinned person.
ethnic: (aj) Of or relating to a group of people having common racial, ancestral, national, religious or cultural origins.; Characteristic of a foreign or a minority group's culture.; Representative of a folk or traditional mode of expression.; Heathen, not Jewish, Christian, or Muslim.(n) An ethnic person, especially a foreigner or member of an immigrant community.; A heathen, a pagan.; The demonym of an Ancient Greek city.
ethos: (n) The character or fundamental values of a person, people, culture, or movement.; A form of rhetoric in which the writer or speaker invokes their authority, competence or expertise in an attempt to persuade others that their view is correct.; The traits in a work of art which express the ideal or typic character, as influenced by the ethos (character or fundamental values) of a people, rather than realistic or emotional situations or individual character in a narrow sense; opposed to pathos.
ethyl: (n) The univalent hydrocarbon radical, C₂H₅, formally derived from ethane by the loss of a hydrogen atom.
Ethyl: (N) Alternative form of Ethel: a female given name.
ethyne: (n) The organic compound acetylene. The simplest alkyne, a colorless gaseous (at room temperature and pressure) hydrocarbon with the chemical formula C₂H₂.
etna: (n) A kind of small, portable cooking apparatus for which heat is furnished by a spirit lamp.
Etna: (N) An active stratovolcano on the east coast of Sicily, Italy, between Messina and Catania.; A city in Siskiyou County, California, United States.; A town in Penobscot County, Maine, United States.(N) A river that flows through Etnedal and Nordre Land municipalities, Oppland, Norway.(N) A female given name from Irish
Eton: (N) A town and civil parish in Windsor and Maidenhead, Berkshire, England (OS grid ref SU965775).; A prestigious public school for boys in the town of Eton.; A town in Murray County, Georgia, United States.; A habitational surname, from Old English.
etude: (n) A short piece of music, designed to give a performer practice in a particular area or skill.
etui: (n) Alternative spelling of étui
etymon: (n) The original or earlier form of an inherited or borrowed word, affix, or morpheme either from an earlier period in a language's development, from an ancestral language, or from a foreign language.
euchre: (n) A trump card game played by four players in two partnerships with a reduced deck of 24 cards.(v) To deceive or outwit.
Euclid: (N) Euclid of Alexandria, a Greek mathematician.; A male given name from Ancient Greek of mostly historical use.; A city in Ohio.; An unincorporated community in West Virginia.
Euler: (N) Leonhard Euler, Swiss mathematician and physicist.
eulogy: (n) An oration to honor a deceased person, usually at a funeral.; Speaking highly of someone or something; the act of praising or commending someone or something.
eunuch: (n) A castrated human male.; Such a man employed as harem guard or in certain (mainly Eastern) monarchies (e.g. late Roman and Chinese Empires) as court or state officials.; A man who is not inclined to marry and procreate.
eure: (n) Obsolete form of ewer.
Eure: (N) One of the départements of Normandy, France. Capital: Évreux (INSEE code 27).; A river in France, tributary to the Seine.
eureka: (i) An exclamation indicating sudden discovery.(n) Synonym of constantan (“copper-nickel alloy”)
Eureka: (N) A rural locality in the Bundaberg Region, Queensland, Australia.; A small suburb of Ballarat, Victoria, Australia.; A community in Pictou County, Nova Scotia, Canada.; A small research base in Fosheim Peninsula, Ellesmere Island, Qikiqtaaluk Region, Nunavut, Canada.; A settlement in Waikato district, New Zealand.; A city, the county seat of Humboldt County, in northern California, United States.; A ghost town in Nevada County, California.; A mining ghost town in San Juan County, Colorado.; A city, the county seat of Woodford County, Illinois.; An unincorporated community in Lawrence County, Indiana, also known as Geiberson.; An unincorporated community in Luce Township, Spencer County, Indiana.; A city, the county seat of Greenwood County, Kansas.; A city in St. Louis County, Missouri.; An unincorporated community in Cinque Hommes Township, Perry County, Missouri.; A town in Lincoln County, Montana.; An unincorporated town and census-designated place, the county seat of Eureka County, Nevada.; A town in Wayne County, North Carolina.; An unincorporated community in Warrington Township, Bucks County and Montgomery Township, Montgomery County, Pennsylvania.; An unincorporated community in Aiken County, South Carolina.; A city in McPherson County, South Dakota.; A ghost town in Crockett County, Texas.; A ghost town in Franklin County, Texas.; A tiny city in Navarro County, Texas.; A small city in Juab County, Utah.; An unincorporated community in Walla Walla County, Washington.; An unincorporated community in Pleasants County, West Virginia.; A town in Polk County, Wisconsin.; An unincorporated CDP in the town of Rushford, Winnebago County, Wisconsin.; A given name, like for the protagonists of Eureka's Castle or Eureka Seven.
eurekas: (n) plural of eureka
Europa: (N) Several characters, most notably a Phoenician princess abducted to Crete by Zeus.; A moon of Jupiter.; 52 Europa, a main belt asteroid; not to be confused with the Jovian moon.
Europe: (N) The portion of Eurasia west of the Urals, traditionally considered a continent in its own right, located north of Africa, west of Asia and east of the Atlantic Ocean.; A political entity; the European Union.; Mainland Europe (continental Europe), especially the western portion, thus excluding the island nations or the larger Mediterranean islands.; International club competitions operated by UEFA, the sport's governing body for Europe.(n) Europe
eurus: (n) The east wind
Eurus: (N) The god of the East Wind.; The east wind personified.
eva: (av) Pronunciation spelling of ever.
Eva: (N) A female given name from Latin, ultimately from Hebrew.
evade: (v) To get away from by cunning; to avoid using dexterity, subterfuge, address, or ingenuity; to cleverly escape from; To escape; to slip away; — sometimes with from.; To attempt to escape; to practice artifice or sophistry, for the purpose of eluding.
evaded: (v) simple past tense and past participle of evade
eve: (n) The day or night before, usually used for holidays, such as Christmas Eve.; Evening, night.; The period of time when something is just about to happen or to be introduced
Eve: (N) The first woman and mother of the human race; Adam's wife.; An unspecified primordial woman, from whom many or all people are descended.; A female given name from Hebrew.; An unincorporated community in Kentucky, United States.; An unincorporated community in Missouri, United States.(N) A conventional name for an agent attempting to intercept a message sent by Alice that is intended for Bob.(N) An English surname.
Evelyn: (N) A female given name from the Germanic languages.; A matronymic surname, from given names.; A male given name transferred from the surname.
even: (aj) Flat and level.; Without great variation.; Equal in proportion, quantity, size, etc.; Divisible by two.; Convenient for rounding other numbers to; for example, ending in a zero.; On equal monetary terms; neither owing nor being owed.; On equal terms of a moral sort; quits.; parallel; on a level; reaching the same limit.; Without an irregularity, flaw, or blemish; pure.; Associate; fellow; of the same condition.(v) To make flat and level.; To equal or equate; to make the same.; To be equal.; To place in an equal state, as to obligation, or in a state in which nothing is due on either side; to balance, as accounts; to make quits.; To set right; to complete.; To act up to; to keep pace with.(av) Exactly, just, fully.; In reality; implying an extreme example in the case mentioned, as compared to the implied reality.; Emphasizing a comparative.; Signalling a correction of one's previous utterance; rather, that is.(n) An even number.(n) Evening.
Even: (N) A Tungusic language spoken by the Evens in Siberia and the Russian Far East.(n) An ethnic Even: a member of an indigenous people living in Siberia and the Russian Far East.
evenly: (av) So as to form a flat surface.; In a fair manner of distribution, giving the same amount or number to each; equally.; In a manner that leaves no remainder.; In terms of or by means of even numbers.
event: (n) An occurrence; something that happens.; A prearranged social activity (function, etc.); One of several contests that combine to make up a competition.; An end result; an outcome (now chiefly in phrases).; A point in spacetime having three spatial coordinates and one temporal coordinate.; A possible action that the user can perform that is monitored by an application or the operating system (event listener). When an event occurs an event handler is called which performs a specific task.; A set of some of the possible outcomes; a subset of the sample space.; An affair in hand; business; enterprise.; An episode of severe health conditions.(v) To occur, take place.(v) To be emitted or breathed out; to evaporate.; To expose to the air, ventilate.
events: (n) plural of event(v) Third-person singular simple present indicative form of event
ever: (av) Always, frequently, forever.; Continuously, constantly, all the time (for the complete duration).; At any time.; In any way.; As intensifier following an interrogative word.(aj) Occurring at any time, occurring even but once during a timespan.(d) Shortening of every
evert: (v) To turn inside out (like a pocket being emptied) or outwards.; To move (someone or something) out of the way.; To turn upside down; to overturn.; To disrupt; to overthrow.
Evert: (N) A surname.
every: (d) All of a countable group (considered individually), without exception.; Denotes equal spacing at a stated interval, or a proportion corresponding to such a spacing.; Denotes an abundance of something.
Every: (N) A surname.
eves: (n) plural of eve
Eves: (n) plural of Eve
evict: (v) To expel (one or more people) from their property; to force (one or more people) to move out.
evil: (aj) Intending to harm; malevolent.; Morally corrupt.; Unpleasant, foul (of odour, taste, mood, weather, etc.).; Producing or threatening sorrow, distress, injury, or calamity; unpropitious; calamitous.; Having harmful qualities; not good; worthless or deleterious.; Undesirable; harmful; bad practice.(n) Moral badness; wickedness; malevolence; the forces or behaviors that are the opposite or enemy of good.; Something which impairs the happiness of a being or deprives a being of any good; something which causes suffering of any kind to sentient beings; harm; injury; mischief.; A malady or disease; especially in combination, as in king's evil, colt evil.(av) wickedly, evilly, iniquitously; injuriously, harmfully; in a damaging way.; badly, poorly; in an insufficient way.
evilly: (av) In an evil manner.
evils: (n) plural of evil; the evil eye
evince: (v) To show or demonstrate clearly; to manifest.
evite: (v) To avoid.
evoke: (v) To call out; to draw out or bring forth.; To cause the manifestation of something (emotion, picture, etc.) in someone's mind or imagination.; To elicit a response.
evoked: (v) simple past tense and past participle of evoke
evokes: (v) Third-person singular simple present indicative form of evoke
evolve: (v) To move in regular procession through a system.; To change; transform.; To come into being; develop.; Of a population, to change genetic composition over successive generations through the process of evolution.; Of a trait, to develop within a population via biological evolution.; Of a population, to acquire or develop (a trait) in the process of biological evolution.; To give off (gas, such as oxygen or carbon dioxide during a reaction).; To cause something to change or transform.
evzone: (n) A member of the Greek presidential guard.; An infantryman of a select corps of the Greek army.
ewe: (n) A female sheep, as opposed to a ram.
Ewe: (n) An ethnic group who inhabit southeastern Ghana, Togo, and Benin.(N) The Niger-Congo language, belonging to the Gbe family, spoken by these people.(aj) Of or pertaining to the Ewe people or language.
EWE: (n) Epilogue, What Epilogue?; a subgenre of Harry Potter fanfiction which pointedly ignores the epilogue of the final novel.
ewer: (n) A kind of widemouthed pitcher or jug with a shape like a vase and a handle.
Ewer: (N) A surname.
ewes: (n) plural of ewe
ex: (n) The name of the Latin-script letter X.(v) To delete; to cross out(n) A former partner or spouse, usually short for ex-girlfriend, ex-boyfriend, ex-wife or ex-husband.(aj) Ex-, former, previously but no longer.(aj) the place the train originated from or called at prior to the present location.(aj) expensive, dear(n) Clipping of exhibition.
exact: (aj) Precisely agreeing with a standard, a fact, or the truth; perfectly conforming; neither exceeding nor falling short in any respect.; Habitually careful to agree with a standard, a rule, or a promise; accurate; methodical; punctual.; Precisely or definitely conceived or stated; strict.; Such that the kernel of one homomorphism is the image of the preceding one.(v) To demand and enforce the payment or performance of, sometimes in a forcible or imperious way.; To make desirable or necessary.; To inflict; to forcibly obtain or produce.(av) exactly
exacts: (v) Third-person singular simple present indicative form of exact
exalt: (v) To honor; to hold in high esteem.; To raise in rank, status etc., to elevate.; To elate, or fill with the joy of success.; To refine or subtilize.
exalts: (v) Third-person singular simple present indicative form of exalt
exam: (n) Clipping of examination, especially when meaning test or in compound terms.(v) Shortened form of examine
examen: (n) examination; inquiry
exarch: (n) In the Byzantine Empire, a governor of a distant province.; In the Eastern Christian Churches, the deputy of a patriarch, or a bishop who holds authority over other bishops without being a patriarch.; In these same churches, a bishop appointed over a group of the faithful not yet large enough or organized enough to constitute an eparchy or diocese.
exceed: (v) To be larger, greater than (something).; To be better than (something).; To go beyond (some limit); to surpass; to be longer than.; To predominate.; To go too far; to be excessive.
excel: (v) To surpass someone or something; to be better or do better than someone or something.; To be much better than others.; To exceed, to go beyond
Excel: (N) A spreadsheet application software program written and distributed by Microsoft.
excels: (v) Third-person singular simple present indicative form of excel
except: (v) To exclude; to specify as being an exception.; To take exception, to object (to or against).(p) with the exception of; but.(c) With the exception (that); used to introduce a clause, phrase or adverb forming an exception or qualification to something previously stated.; Unless; used to introduce a hypothetical case in which an exception may exist.
excess: (n) The state of surpassing or going beyond a limit; the state of being beyond sufficiency, necessity, or duty; more than what is usual or proper.; The degree or amount by which one thing or number exceeds another; remainder.; An act of eating or drinking more than enough.; Spherical excess, the amount by which the sum of the three angles of a spherical triangle exceeds two right angles. The spherical excess is proportional to the area of the triangle.; A condition on an insurance policy by which the insured pays for a part of the claim.(aj) More than is normal, necessary or specified.(v) To declare (an employee) surplus to requirements, such that he or she might not be given work.
excide: (v) To cut off.
excise: (n) A tax charged on goods produced within the country (as opposed to customs duties, charged on goods from outside the country).(v) To impose an excise tax on something.(v) To cut out; to remove.
excite: (v) To stir the emotions of.; To arouse or bring out (e.g. feelings); to stimulate.; To cause an electron to move to a higher than normal state; to promote an electron to an outer level.; To energize (an electromagnet); to produce a magnetic field in.
excuse: (v) To forgive; to pardon.; To allow to leave, or release from any obligation.; To provide an excuse for; to explain, with the aim of alleviating guilt or negative judgement.; To relieve of an imputation by apology or defense; to make apology for as not seriously evil; to ask pardon or indulgence for.(n) Explanation designed to avoid or alleviate guilt or negative judgment; a plea offered in extenuation of a fault.; A defense to a criminal or civil charge wherein the accused party admits to doing acts for which legal consequences would normally be appropriate, but asserts that special circumstances relieve that party of culpability for having done those acts.; An example of something that is substandard or of inferior quality.
exeat: (n) A license or permit for absence from a university or a religious house (such as a monastery).; A permission which a bishop grants to a priest to go out of his diocese.; Leave of absence from a boarding school.; A stage direction to leave the stage.
exedra: (n) A semicircular recess, with stone benches, used as a place for discussion.; A curved bench with a high back.
exempt: (aj) Free from a duty or obligation.; Not entitled to overtime pay when working overtime.; Cut off; set apart.; Extraordinary; exceptional.(n) One who has been released from something.; A type of French police officer.; One of four officers of the Yeomen of the Royal Guard, having the rank of corporal; an exon.(v) To grant (someone) freedom or immunity from.
exert: (v) To put in vigorous action.; To make use of, to apply, especially of something non-material.
exerts: (v) Third-person singular simple present indicative form of exert
Exeter: (N) A city and local government district, the county town of Devon, in south-west England.; A village in New South Wales, Australia.; A suburb of Adelaide, South Australia.; A small town in Tasmania, Australia.; A community in Huron County, Ontario, Canada.; A number of places in the United States:; A city in Tulare County, California.; A number of places in the United States:; A village in Lebanon, Connecticut.; A number of places in the United States:; A village in Scott County, Illinois.; A number of places in the United States:; A town in Penobscot County, Maine.; A number of places in the United States:; A city in Barry County, Missouri.; A number of places in the United States:; A village in Fillmore County, Nebraska.; A number of places in the United States:; A town in Rockingham County, New Hampshire.; A number of places in the United States:; A town in Otsego County, New York.; A number of places in the United States:; A ghost town in Licking County, Ohio.; A number of places in the United States:; A borough of Luzerne County, Pennsylvania.; A number of places in the United States:; A town in Washington County, Rhode Island.; A number of places in the United States:; An unincorporated community and coal town in Wise County, Virginia.; A number of places in the United States:; A town and unincorporated community in Green County, Wisconsin.; Ellipsis of Exeter College, Oxford.
exeunt: (n) A stage direction for more than one actor to leave the stage.; An act of one or more actors leaving the stage.(v) They leave the stage (a stage direction to two or more actors, the plural counterpart of exit).
exhale: (v) To expel air from the lungs through the nose or mouth by action of the diaphragm, to breathe out.; To expel (something, such as tobacco smoke) from the lungs by action of the diaphragm.; To pass off in the form of vapour; to emerge.; To emit (a vapour, an odour, etc.).; To draw out; to cause to be emitted in vapour.(n) An exhalation.
exhort: (v) To urge; to advise earnestly.
exhume: (v) To dig out of the ground; to take out of a place of burial; to disinter.; To uncover; to bring to light.
exile: (n) The state of being banished from one's home or country.; Someone who is banished from their home or country.(v) To send into exile.
exiled: (v) simple past tense and past participle of exile
exiles: (n) plural of exile(v) Third-person singular simple present indicative form of exile
exine: (n) the outer layer of a pollen grain or spore; the exosporium.
exist: (v) to be; have existence; have being or reality
exists: (v) Third-person singular simple present indicative form of exist
exit: (n) An act of going out or going away, or leaving; a departure.; The action of an actor leaving a scene or the stage.; A way out.; An opening or passage through which one can go from inside a place (such as a building, a room, or a vehicle) to the outside; an egress.; A way out.; A minor road (such as a ramp or slip road) which is used to leave a major road (such as an expressway, highway, or motorway).; The act of departing from life; death.(v) To go out or go away from a place or situation; to depart, to leave.; To leave a scene or depart from a stage.; To depart from life; to die.; To end or terminate (a program, subroutine, etc.); To depart from or leave (a place or situation).; To alight or disembark from a vehicle.; To give up the lead.(v) Used as a stage direction for an actor: to leave the scene or stage.
exits: (n) plural of exit(n) Income, returns, revenue.(v) Third-person singular simple present indicative form of exit
Exmoor: (N) A moor and national park in Devon and Somerset, southern England.(n) One of a breed of horned sheep of Devonshire, England, with white legs and face and black nostrils.; One of a breed of ponies native to the Exmoor district.
exodus: (n) A sudden departure of a large number of people.(v) To depart from a place in a large group.
Exodus: (N) The departure of the Hebrew slaves from Egypt under the leadership of Moses.; The second of the Books of Moses in the Old Testament of the Bible, the second book in the Torah describing the Exodus.
exon: (n) An officer of the Queen's Body Guard of the Yeomen of the Guard.(n) A region of a transcribed gene present in the final functional RNA molecule.
exotic: (aj) Foreign, especially in an exciting way.; Non-native to the ecosystem.; Being or relating to an option with features that make it more complex than commonly traded options.; Being or relating to various wagers, such as the trifecta, that involve betting on the finishing positions of multiple competitors across one or more races.(n) An organism that is exotic to an environment.; An exotic dancer; a stripteaser.; Any exotic particle.
expand: (v) To change (something) from a smaller form or size to a larger one; to spread out or lay open.; To increase the extent, number, volume or scope of (something).; To express (something) at length and/or in detail.; To rewrite (an expression) as a longer, yet equivalent sum of terms.; To become, by rewriting, a longer, yet equivalent sum of terms.; To multiply both the numerator and the denominator of a fraction by the same natural number yielding a fraction of equal value; To change or grow from smaller to larger in form, number, or size.; To increase in extent, number, volume or scope.; To speak or write at length or in detail.; To feel generous or optimistic.
expect: (v) To predict or believe that something will happen; To consider obligatory or required.; To consider reasonably due.; To be pregnant, to consider a baby due.; To wait for; to await.; To wait; to stay.
expel: (v) To eject or erupt.; To fire (a bullet, arrow etc.).; To remove from membership.; To deport.
expend: (v) to consume, exhaust (some resource); to spend, disburse
expert: (aj) Extraordinarily capable or knowledgeable.; Characteristic of an expert.; Proven, experienced, veteran.(n) A person with extensive knowledge or ability in a given subject.; A player ranking just below master.
experted: (v) plural of expert
experting: (v) plural of expert
expire: (v) To die.; To lapse and become invalid.; To come to an end; to conclude.; To exhale; to breathe out.; To give forth insensibly or gently, as a fluid or vapour; to emit in minute particles.; To bring to a close; to terminate.
expiry: (n) End; termination; expiration.; Death.; Synonym of expiration date
export: (aj) of or relating to exportation or exports(n) something that is exported; the act of exporting(v) To carry away.; To sell (goods) to a foreign country.; To cause to spread in another part of the world.; To send (data) from one program to another.; To put up (a child) for international adoption.
expose: (v) To reveal, uncover, make visible, bring to light, introduce (to).; To subject photographic film to light thereby recording an image.; To abandon, especially an unwanted baby in the wilderness.; To submit to an active (mostly dangerous) substance like an allergen, ozone, nicotine, solvent, or to any other stress, in order to test the reaction, resistance, etc.; To make available to other parts of a program, or to other programs.
exsect: (v) To cut out or away; to remove by exsection.
exsert: (v) To thrust out; to cause to protrude.(aj) Standing out; projecting beyond some other part.
extant: (aj) Still in existence.; Currently existing; not having disappeared.; Still alive; not extinct.; Standing out, or above the rest.
extend: (v) To increase in extent.; To possess a certain extent; to cover an amount of space.; To cause to increase in extent.; To cause to last for a longer period of time.; To straighten (a limb).; To bestow; to offer; to impart; to apply.; To increase in quantity by weakening or adulterating additions.; To value, as lands taken by a writ of extent in satisfaction of a debt; to assign by writ of extent.; Of a class: to be an extension or subtype of, or to be based on, a prototype or a more abstract class.; To reenlist for a further period.(n) Misspelling of extent.
extent: (n) A range of values or locations.; The space, area, volume, etc., to which something extends.; A contiguous area of storage in a file system.; The valuation of property.; A writ directing the sheriff to seize the property of a debtor, for the recovery of debts of record due to the Crown.(aj) Extended.
extern: (n) A person affiliated with an institution in a lesser capacity, for example, as a non-resident or as a part-time affiliate.; A day-scholar.; Outward form or part; exterior.(aj) External; outward; not inherent(n) In the C and C++ programming languages, a variable that can be separately declared in many places, all of them referring to the same variable.
extine: (n) The outer membrane of the grains of pollen of flowering plants.
extol: (v) To praise; to make high.
extort: (v) To take or seize from an unwilling person by physical force, menace, duress, torture, or any undue or illegal exercise of power or ingenuity.; To obtain by means of the offense of extortion.; To twist outwards.(aj) Wrongfully obtained.
extra: (aj) Beyond what is due, usual, expected, or necessary; extraneous; additional; supernumerary.; Extraordinarily good; superior.; Over the top; going beyond what is normal or appropriate, often in a dramatic manner.(d) Denotes more.(av) To an extraordinary degree.(n) Something additional, such as an item above and beyond the ordinary school curriculum, or added to the usual charge on a bill.; An extra edition of a newspaper, which is printed outside of the normal printing cycle, for example to report an important late-breaking event.; A run scored without the ball having hit the striker's bat - a wide, bye, leg bye or no ball.; A supernumerary or walk-on in a film or play.; The state or trait of being over the top, of behaving in an overly dramatic manner.; Something of an extra quality or grade.
extras: (n) plural of extra
exude: (v) To discharge through pores or incisions, as moisture or other liquid matter; to give out.; To flow out through the pores.; To give off or radiate a certain quality or emotion, often strongly.
exuded: (v) simple past tense and past participle of exude
exult: (v) To rejoice; to be very happy, especially in triumph.
exults: (v) Third-person singular simple present indicative form of exult
exurb: (n) A residential area beyond the suburbs.
eyas: (n) A young hawk or falcon in the nest, or that has not yet fledged, especially one that will be trained for falconry.
eye: (n) An organ through which animals see (perceive surroundings via light).; The visual sense.; The iris of the eye, being of a specified colour.; Attention, notice.; The ability to notice what others might miss.; A meaningful stare or look.; A private eye: a privately hired detective or investigator.; A hole at the blunt end of a needle through which thread is passed.; The oval hole of an axehead through which the axehandle is fitted.; A fitting consisting of a loop of metal or other material, suitable for receiving a hook or the passage of a cord or line.; The relatively clear and calm center of a hurricane or other cyclonic storm.; A mark on an animal, such as a peacock or butterfly, resembling a human eye.; The dark spot on a black-eyed pea.; A reproductive bud in a potato.; The dark brown center of a black-eyed Susan flower.; A loop forming part of anything, or a hole through anything, to receive a rope, hook, pin, shaft, etc. — e.g. at the end of a tie bar in a bridge truss; through a crank; at the end of a rope; or through a millstone.; That which resembles the eye in relative importance or beauty.; Tinge; shade of colour.; One of the holes in certain kinds of cheese.; The circle in the centre of a volute.; The enclosed counter (negative space) of the small letter e.; An empty point or group of points surrounded by one player's stones.; View or opinion.(v) To carefully or appraisingly observe (someone or something).; To appear; to look.; To remove the reproductive buds from (potatoes).; To allow (fish eggs) to develop so that the black eye spots are visible.(n) A brood.
Eye: (N) A place name, including:; A small village in north Herefordshire, England (OS grid ref SO4963).; A place name, including:; A small town in Suffolk, England.; A place name, including:; A short river in Cotswold district, Gloucestershire, England, which joins the River Dikler.; A place name, including:; A river in Melton borough, Leicestershire, England, which becomes the River Wreake.(N) the comedic magazine Private Eye.; The London Eye, a tourist attraction in London.
eyecup: (n) an eyebath; coon eyes; A shield surrounding the eyepiece of a camera.
eyed: (aj) Having eyes.; Having eye-like spots.; Having the specified kind or number of eyes.(v) simple past tense and past participle of eye
eyeful: (n) A full or complete view; a good look.; A remarkable sight or a very attractive person.; An amount of material blown into the eye.(aj) Filling or attractive to the eye; visible; remarkable.
eyeing: (v) present participle of eye
eyelet: (n) An object that consists of a rim and small hole or perforation to receive a cord or fastener, as in garments, sails, etc. An eyelet may reinforce a hole.; A shaped metal embellishment containing a hole, used in scrapbook. Eyelets are typically set by punching a hole in the page, placing the smooth side of the eyelet on a table, positioning the paper over protruding edge and curling the edge down using a hammer and eyelet setter.; Cotton fabric with small holes.; The contact tip of the base of a light bulb.; A peephole.; A little eye.(v) To make eyelets in.
eyeletting: (v) plural of eyelet
eyelid: (n) A thin skin membrane that covers and moves over an eye.
eyes: (n) plural of eye(v) Third-person singular simple present indicative form of eye
eying: (v) present participle of eye
eyne: (n) plural of eye
eyot: (n) A little island, especially in a river or lake.
eyra: (n) A slender, reddish-yellow wild cat (Puma yagouaroundi eyra) ranging from southern Brazil to Texas.
eyre: (n) A journey in circuit of certain itinerant judges called justices in eyre (or in itinere).
Eyre: (N) A surname.
eyrie: (n) The nest of a bird of prey.; Any high and remote but commanding place.
eyrir: (n) A subdivision of currency, equal to one hundredth of an Icelandic króna
Ezra: (N) The fifteenth book of the Old Testament and a book of the Hebrew Tanakh.; A Jewish high priest from the fifth century BC.; A male given name from Hebrew of biblical origin.; A surname, from Hebrew.
