u: (C) The twenty-first letter of the English alphabet, called u and written in the Latin script.(S) (a) an initial letter ⟨u⟩(n) The name of the Latin-script letter U.; A thing in the shape of the letter U(P) you (in text messaging and internet conversations)
U: (C) The twenty-first letter of the English alphabet, called u and written in the Latin script.(n) A U-turn.(aj) Usually in parentheses: abbreviation of unclassified.; In a film certificate: abbreviation of universal (“suitable for all ages”).(N) A language belonging to the Austroasiatic language family which is spoken in China.(N) Alternative form of Ü (“Tibetan language”)
ubiety: (n) The state of existing in a specific point in space, thereness.; Omnipresence; ubiquity.
udder: (n) An organ formed of the mammary glands of female quadruped mammals, particularly ruminants such as cattle, goats, sheep and deer.; A woman's breast.
Udine: (N) A city in Friuli-Venezia Giulia, Italy.
udo: (n) Japanese spikenard
udos: (n) plural of udo
ufo: (n) A UFO.
UFO: (n) An "unfinished object" in knitting or other kinds of craft.
Uganda: (N) A country in Eastern Africa. Official name: Republic of Uganda
ugh: (i) Used to express repugnance, disgust, or annoyance.; Used to express inarticulate vocalisations, such as used by a caveman.
ughs: (n) plural of ugh
uglier: (aj) comparative form of ugly: more ugly
uglify: (v) To make ugly; to destroy or worsen the appearance or attractiveness of.; To become ugly.
ugly: (aj) Displeasing to the eye; not aesthetically pleasing.; Displeasing to the ear or some other sense.; Offensive to one's sensibilities or morality.; Ill-natured; crossgrained; quarrelsome.; Unpleasant; disagreeable; likely to cause trouble or loss.(n) Ugliness.; An ugly person or thing.; Any product whose size and shape prevents it from fitting neatly on a pallet.; A shade for the face, projecting from a bonnet.(v) To make ugly (sometimes with up).
Ugrian: (n) A member of the race of ancestors of the present Hungarians.
Ugric: (aj) Of or pertaining to a group of languages that includes Hungarian, Khanty and Mansi.(N) A group of languages that includes Hungarian, Khanty and Mansi.
uhlan: (n) A lancer, a soldier armed with a lance in a former light cavalry unit of the Polish, Prussian/German, Austrian, and Russian armies.
ukase: (n) An authoritative proclamation; an edict, especially decreed by a Russian czar or (later) emperor.; Any absolutist order or arrogant proclamation
Ukase: (n) Alternative letter-case form of ukase
ulcer: (n) An open sore of the skin, eyes or mucous membrane, often caused by an initial abrasion and generally maintained by an inflammation and/or an infection.; Peptic ulcer.; Anything that festers and corrupts like an open sore; a vice in character.
ulcers: (n) plural of ulcer
ullage: (n) In a wine bottle, the empty space between the cork and the top of the wine.; In a cask or barrel, the empty space, occupied by air, that is created by not completely filling the cask or barrel, or through spillage.; The topping-up of such a barrel with fresh wine.; In an industrial setting, the empty space in a tank, especially as for fuel.(v) To gauge the amount of empty space between the top of a cask and the level of liquid inside it.
Ulm: (N) A city on the River Danube in Baden-Württemberg, Germany
ulna: (n) The bone of the forearm that extends from the elbow to the wrist on the side opposite to the thumb, corresponding to the fibula of the hind limb. Also, the corresponding bone in the forelimb of any vertebrate.
ulster: (n) A long, loose overcoat made of wool or other rough material, often called a greatcoat, which sometimes features an attached shoulder cape covering the back and sleeves, and which can sometimes be buttoned in front.
Ulster: (N) The northern province of Ireland, made up of all six Northern Irish counties and three counties in the Republic of Ireland.; The six counties that make up Northern Ireland.; A county named after the Irish province in New York State, United States of America.(n) Alternative letter-case form of ulster (“men's heavy overcoat”)
ult: (n) The final (ultimate) syllable of a word or other utterance.
ultima: (n) The final syllable of a word.; A third-order measure of derivative price sensitivity, expressed as the rate of change of vomma with respect to changes in the volatility of the underlying asset.
Ultima: (N) A town in Victoria, Australia.(N) The larger lobe of the trans-Neptunian object Ultima Thule, a contact binary object.
ultimo: (aj) On the last day (of a specified month).(av) Of last month.(n) = ultimum
ultra: (aj) Extreme; far beyond the norm; fanatical; uncompromising.(n) An ultraroyalist in France.; An extremist, especially an ultranationalist.; An especially devoted football fan, typically associated with the intimidating use of extremist slogans, pyrotechnics and sometimes hooligan violence.; An ultramarathon.; An ultra-prominent peak.; Code name used by British codebreakers during World War 2 for decrypted information gained from the enemy.
um: (i) Expression of hesitation, uncertainty or space filler in conversation. See uh.; Dated spelling of mmm.(v) To make the um sound to express uncertainty or hesitancy.(p) Alternative form of umbe(pa) An undifferentiated determiner or article; a miscellaneous linking word, or filler with nonspecific meaning; representation of broken English stereotypically or comically attributed to Native Americans.
umbel: (n) A flat-topped or rounded flower-cluster (= inflorescence) in which the individual flower stalks arise from the same point, the youngest flowers being at the centre.
umber: (n) A brown clay, somewhat darker than ochre, which contains iron and manganese oxides.; Alternative form of umbrere; A grayling.; A dusky brown African wading bird (Scopus umbretta) allied to the shoebill and herons; a hamerkop.(aj) Of a reddish brown colour, like that of the pigment.(v) To give a reddish-brown colour to.
umbles: (n) Animal entrails, especially of a deer.
umbra: (n) The fully shaded inner region of a shadow cast by an opaque object.; The area on the earth or moon experiencing the total phase of an eclipse.; The central region of a sunspot.; A shadow.; An uninvited guest brought along by one who was invited.; One of the family Umbridae of mudminnows.; A sciaenoid fish, the umbrine.
Umbria: (N) A region of Italy.
umiak: (n) A large, open boat made of skins stretched over a wooden frame that is propelled by paddles; used by the Eskimos for transportation.
umlaut: (n) An assimilatory process whereby a vowel is pronounced more like a following vocoid that is separated by one or more consonants.; The umlaut process (as above) that occurred historically in Germanic languages whereby back vowels became front vowels when followed by syllable containing a front vocoid (e.g. Germanic lūsiz > Old English lȳs(i) > Modern English lice).; A vowel so assimilated.; The diacritical mark ( ¨ ) placed over a vowel when it indicates a (rounded) front vowel; A diaeresis.(v) To place an umlaut over (a vowel).; To modify (a word) so that an umlaut is required in it.
umpire: (n) The official who presides over a tennis game sat on a high chair.; One of the two white-coated officials who preside over a cricket match.; One of usually 4 officials who preside over a baseball game.; The official who stands behind the line on the defensive side.; A match official on the ground deciding and enforcing the rules during play. As of 2007 the Australian Football League uses three; in the past there were two or just one. The other officials, the goal umpires and boundary umpires, are usually referred to by those phrases.; A person who arbitrates between contending parties.; The official who presides over a curling game.(v) To act as an umpire in a game.; To decide as an umpire.
ums: (n) plural of um(v) Third-person singular simple present indicative form of um
un: (n) Alternative spelling of 'un
Un: (N) A surname.
Una: (N) A female given name from Irish.
unable: (aj) Not able; lacking a certain ability.(i) Indicating that a requested course of action is not possible to carry out.(v) To render unable; to disable.
unapt: (aj) Not apt, inappropriate, unsuited.; Unaccustomed.
unarm: (v) To disarm, to remove the armour and weapons from.; To remove one's armour.
unbar: (v) To unlock or unbolt a door that had been locked or bolted with a bar.; To remove an impediment that obstructs the passage of (someone or something).; To remove a prohibition.
unbelt: (v) To remove a belt; to relax, unwind
unbend: (v) To remove a bend so as to make, or allow to become, straight.; To release (a load) from a strain or from exertion; to set at ease for a time; to relax.; To unfasten sails from the spars or stays to which are attached for use.; To cast loose or untie; To cease to be bent; to become straight.; To relax in exertion, attention, severity, or the like; to enjoy oneself; to become affable and free from formality
unbent: (v) simple past tense and past participle of unbend(aj) Not bent; Erect, upright, or straight
unbind: (v) To take bindings off.; To set free from a debt, contract or promise.; To disable some kind of connection in software, such as a key binding.
unbolt: (v) To unlock by undoing the bolts of.
unborn: (aj) Not yet born; yet to come; future.; Not yet delivered; still existing in the mother's womb.; Existing without birth or beginning.(n) A single unborn offspring at any stage of gestation.; Unborn offspring collectively.
uncap: (v) To remove a cap or cover from.; To take off one's cap.
uncial: (aj) Of or relating to an ounce, or an inch, especially to letters printed an inch high.(aj) Of or relating to a majuscule style of writing with unjoined, rounded letters, originally used in the 4th–9th centuries.(n) A style of writing using uncial letters.; A letter in this style.; A manuscript in this style.
unclad: (aj) Without clothing or other covering.
uncle: (n) The brother or brother-in-law of one’s parent.; The male cousin of one’s parent.; A companion to one's (usually unmarried) mother.; A source of advice, encouragement, or help.; A pawnbroker.; An affectionate term for a man of an older generation than oneself, especially a friend of one's parents, by means of fictive kin.; An older African-American male.; Any middle-aged or elderly man older than the speaker and/or listener.(i) A cry used to indicate surrender.(v) To address somebody by the term uncle.; To act like, or as, an uncle.
uncles: (n) plural of uncle(v) Third-person singular simple present indicative form of uncle
unclog: (v) To remove a blockage from.; To have a blockage removed.
unco: (aj) Strange, weird.(av) Very.(aj) Uncoordinated.
uncoer: (adj) plural of unco
uncoes: (n) plural of unco
uncoest: (adj) plural of unco
uncoil: (v) To unwind or untwist (something).; To unwind or untwist oneself.
uncork: (v) To open (a bottle or other container sealed with a cork or stopper) by removing the cork or stopper from.; To release.
uncos: (n) plural of unco
uncurl: (v) To straighten out from being curled up.
uncut: (aj) Not cut.; Not cut or ground to the desired shape.; Not having the page edges trimmed.; Not edited or abridged by a censor.; Not diluted.; Not circumcised.
under: (p) In or at a lower level than, so as to be covered or surmounted by.; Below the surface of.; From one side of to the other, passing beneath.; Less than.; Subordinate to; subject to the control of; in accordance with; in compliance with.; Within the category, classification or heading of.; In the face of; in response to (some attacking force).; Using or adopting (a name, identity, etc.).(av) In or to a lower or subordinate position, or a position beneath or below something, physically or figuratively.; So as to pass beneath something.; Insufficiently.; In or into an unconscious state.(aj) Lower; beneath something.; In a state of subordination, submission or defeat.; Under anesthesia, especially general anesthesia; sedated.; Insufficient or lacking in a particular respect.(n) The amount by which an actual total is less than the expected or required amount.
undid: (v) simple past tense of undo
undies: (n) underwear, underpants(v) Third-person singular simple present indicative form of undie
undine: (n) A female water-sprite or nymph.; The elemental being of water.; a small flask used to apply lotions to the eye.
Undine: (N) A female given name from Latin.
undo: (v) To reverse the effects of an action.; To unfasten.; To impoverish or ruin, as in reputation; to cause the downfall of.(n) An operation that reverses a previous action.(aj) Misspelling of undue.
undone: (aj) Not done.(aj) Not fastened.; Ruined; brought to nought.(v) past participle of undo
undue: (aj) Excessive; going beyond that what is natural or sufficient.; That which ought not to be done; illegal; unjustified.; Not owing or payable.
unduly: (av) Undeservedly; in a way that is not warranted.
uneasy: (aj) Not easy; difficult.(aj) Restless; disturbed by pain, anxiety; Not easy in manner; constrained; Causing discomfort or constraint
uneven: (aj) Not even; Not level or smooth; Not uniform; Varying in quality; Odd(v) To make uneven.
unfair: (aj) not fair, unjust; not beautiful; uncomely; unattractive; sorrowful; sad; unseemly; disgraceful(v) to make ugly
unfelt: (aj) Not felt or experienced; without feeling or sensing.; Insincere.
unfit: (aj) Not fit; not having the correct requirements.; Not fit, not having a good physical demeanor.(v) To make unfit; to render unsuitable, spoil, disqualify.
unfix: (v) To unfasten from a fixing.
unfold: (v) To undo a folding.; To turn out; to happen; to develop.; To reveal.; To open (anything covered or closed); to lay open to view or contemplation; to bring out in all the details, or by successive development.; To release from a fold or pen.(n) In functional programming, a kind of higher-order function that is the opposite of a fold.
unfurl: (v) To unroll or release something that had been rolled up, typically a sail or a flag.; To roll out or debut anything.; To open up by unrolling.; To turn out or unfold; to evolve; to progress.
unglue: (v) to separate that which was held by glue; to cease to adhere to or follow attentively
ungual: (aj) Pertaining to or resembling a creature's nail, claw or hoof; unguinal.(n) A modified toe bone, typically ending in a hoof or claw.
ungula: (n) A hoof, claw, or talon.; A section of a cylinder, cone, or other solid of revolution, cut off by a plane oblique to the base; so called from its resemblance to the hoof of a horse. [[File:Ungula (PSF).png|thumb|]]; Alternative form of unguis; A surgical instrument for use in removing a dead fetus.
unhair: (v) To remove hair from (something), especially from hide.; To become free from hair.
unhand: (v) To release from the hand; to let go.
unhelm: (v) To remove the helm from.
unhewn: (aj) Not hewn.
unholy: (aj) Not holy; (by extension) evil, impure, or otherwise perverted.; Dreadful, terrible, excessive, or otherwise atrocious.
unhook: (v) To remove from a hook.; To unfasten by means of hooks.; To unfasten the bra of (its wearer).
unhurt: (aj) Not hurt; unharmed or unscathed
uni: (n) University.(n) Sea urchin eaten as sushi.
Uniat: (aj) Alternative spelling of Uniate(n) Alternative spelling of Uniate
unific: (aj) Producing unity; combining separate things into a single whole.
unify: (v) Cause to become one; make into a unit; consolidate; merge; combine.; Become one.
union: (n) The act of uniting or joining two or more things into one.; The state of being united or joined; a state of unity or harmony.; That which is united, or made one; something formed by a combination or coalition of parts or members; a confederation; a consolidated body; a league.; A trade union; a workers' union.; An association of students at a university for social and/or political purposes; also in some cases a debating body.; A joint or other connection uniting parts of machinery, such as pipes.; The set containing all of the elements of two or more sets.; The act or state of marriage.; Sexual intercourse.; A data structure that can store any of various types of item, but only one at a time.; A large, high-quality pearl.; An affiliation of several parishes for joint support and management of their poor; also the jointly-owned workhouse.(v) To combine sets using the union operation.(aj) Belonging to, represented by, or otherwise pertaining to a labour union.
Union: (n) The 0-10-2 locomotive wheel arrangement.(N) The United States of America.; Those of the United States that did not secede at the time of the Civil War (of the United States of America).; Place names:; A community in Central Elgin, Elgin County, Ontario, Canada.; Place names:; A barangay of Ubay, Bohol, Philippines.; Place names:; A village on the south cast of the island of Siargao, Surigao del Norte, Philippines.; Place names:; A town in Greene County, Alabama, United States.; Place names:; A ghost town in Merced County, California, United States.; Place names:; A former unincorporated community in Napa County, California, United States.; Place names:; A small town in Tolland County, Connecticut, United States.; Place names:; A village in McHenry County, Illinois, United States.; Place names:; An unincorporated community in Clay Township, Pike County, Indiana, United States.; Place names:; A tiny city in Hardin County, Iowa, United States.; Place names:; A home rule city in Boone County, Kentucky, United States.; Place names:; A town in Knox County, Maine, United States.; Place names:; A town in Neshoba County and Newton County, Mississippi, United States.; Place names:; A city, the county seat of Franklin County, Missouri, United States.; Place names:; An unincorporated community in Clark County, Missouri, United States.; Place names:; A village in Cass County, Nebraska, United States.; Place names:; A village and census-designated place in the town of Wakefield, Carroll County, New Hampshire, United States.; Place names:; A hamlet in Madison County, New York, United States.; Place names:; A large town in Broome County, New York, United States.; Place names:; A city in Montgomery County and Miami County, Ohio, United States.; Place names:; A city in Union County, Oregon, United States.; Place names:; A city, the county seat of Union County, South Carolina, United States.; Place names:; An unincorporated community in Floyd County, Virginia, United States.; Place names:; A small town, the county seat of Monroe County, West Virginia, United States.; Place names:; A small town in Burnett County, Wisconsin, United States.; Place names:; A small town in Door County, Wisconsin, United States.; Place names:; A town and unincorporated community in Eau Claire County, Wisconsin, United States.; Place names:; An unincorporated community in the town of Lima, Grant County, Wisconsin, United States.; Place names:; A small town in Pierce County, Wisconsin, United States.; Place names:; A town and unincorporated community in Rock County, Wisconsin, United States.; Place names:; A small town in Vernon County, Wisconsin, United States.; Place names:; A small town in Waupaca County, Wisconsin, United States.(N) A surname.(N) The Oxford Union (a debating society); not to be conflated with Oxford University Student Union (a students' union).
unions: (n) plural of union(v) Third-person singular simple present indicative form of union
Unions: (n) plural of Union
unipod: (n) monopod
unique: (aj) Being the only one of its kind; unequaled, unparalleled or unmatched.; Of a feature, such that only one holder has it.; Particular, characteristic.; Of a rare quality, unusual.(n) A thing without a like; something unequalled or unparallelled; one of a kind.
unis: (n) plural of uni
unison: (n) Identical pitch between two notes or sounds; the simultaneous playing of notes of identical pitch (or separated by one or more octaves).; A sound or note having the same pitch as another, especially when used as the base note for an interval; a unison string.; The state of being in harmony or agreement; harmonious agreement or togetherness, synchronisation.; Two or more voices speaking the same words together.
UNISON: (N) A public-sector trade union in the United Kingdom.
unit: (n) Oneness, singularity, seen as a component of a whole number; a magnitude of one.; A standard measure of a quantity.; The number one.; Clipping of international unit.; An organized group comprising people and/or equipment.; A member of a military organization.; Any military element whose structure is prescribed by competent authority, such as a table of organization and equipment; specifically, part of an organization.; An organization title of a subdivision of a group in a task force.; A standard or basic quantity into which an item of supply is divided, issued, or detailed. In this meaning, also called unit of issue.; With regard to Reserve Components of the Armed Forces, denotes a Selected Reserve unit organized, equipped, and trained for mobilization to serve on active duty as a unit or to augment or be augmented by another unit. Headquarters and support functions without wartime missions are not considered units.; The identity element, neutral element.; An element having an inverse, an invertible element; an associate of the unity.; In an adjunction, a natural transformation from the identity functor of the domain of the left adjoint functor to the composition of the right adjoint functor with the left adjoint functor.; A volume of rock or ice of identifiable origin and age range that is defined by the distinctive and dominant, easily mapped and recognizable petrographic, lithologic or paleontologic features (facies) that characterize it.; An item which may be sold singly.; A unit of alcohol.; One kilowatt-hour (as recorded on an electricity meter).; a measure of housing equivalent to the living quarters of one household; an apartment where a group of apartments is contained in one or more multi-storied buildings or a group of dwellings is in one or more single storey buildings, usually arranged around a driveway.; A gold coin of the reign of James I, worth twenty shillings.; A work unit.; A physically large person.(aj) For each unit.; Having a size or magnitude of one.
unite: (v) To bring together as one.; To come together as one.(n) A British gold coin worth 20 shillings, first produced during the reign of King James I, and bearing a legend indicating the king's intention of uniting the kingdoms of England and Scotland.
united: (v) simple past tense and past participle of unite(aj) Joined into a single entity.; Involving the joint activity of multiple agents.
United: (N) any of many football teams formed by the amalgamation of smaller ones
unites: (v) Third-person singular simple present indicative form of unite
units: (n) plural of unit
unity: (n) Oneness; the state or fact of being one undivided entity.; Agreement; harmony.; A single undivided thing, seen as complete in itself.; Any of the three classical rules of drama: unity of action (nothing should be admitted not directly relevant to the development of the plot), unity of place (the scenes should be set in the same place), and unity of time (all the events should be such as might happen within a single day).; The number 1 or any element of a set or field that behaves under a given operation as the number 1 behaves under multiplication.; The peculiar characteristics of an estate held by several in joint tenancy.; The form of consensus in a Quaker meeting for business which signals that a decision has been reached. In order to achieve unity, everyone who does not agree with the decision must explicitly stand aside, possibly being recorded in the minutes as doing so.
Unity: (N) A female given name from English.; A town in Saskatchewan, Canada.; An unincorporated community in Franklin County, Georgia.; An unincorporated community in Alexander County, Illinois, also known as Hodges Park Station.; A small unincorporated community in Boyd County, Kentucky.; A town and census-designated place in Waldo County, Maine.; An unorganized territory in Kennebec County, Maine.; An unincorporated community in Scotland County, Missouri.; A town in Sullivan County, New Hampshire.; An unincorporated community in Adams County, Ohio.; An unincorporated community in Columbiana County, Ohio.; A tiny city in Baker County, Oregon.; An unincorporated community in Lane County, Oregon.; A small town in Clark County, Wisconsin.; A village in Clark County and Marathon County, Wisconsin, located partly within the town of Unity.; A small town in Trempealeau County, Wisconsin.; A state of South Sudan.
unjust: (aj) Not fair, just or right.
unkind: (aj) Lacking kindness, sympathy, benevolence, gratitude, or similar; cruel, harsh or unjust; ungrateful.; Not kind; contrary to nature or type; unnatural.; Having no race or kindred; childless.
unknit: (v) To unravel.; To undo knitted stitches by reversing the knitting motion.(aj) Not knitted.
unknot: (n) In knot theory, a loop that is not knotted.(v) To unfasten (a knot).
unlace: (v) To remove the knot from laces; to undo laces.; To loosen the clothing of (a person).; To remove (film) from a projector.
unlade: (v) To unload.; To disburden; take the burden from; relieve.; To discharge the cargo from.; To discharge a cargo; discharge a burden.
unlash: (v) To unfasten.
unlaste: (v) plural of unlace
unlay: (v) To untwist.
unless: (c) Except on a specified condition; if not.; If not; used with counterfactual conditionals.; Except if; used with hypothetical conditionals.
unlike: (aj) Not like; dissimilar (to); having no resemblance.; Unequal.; Not likely; improbable; unlikely.(p) Differently from; not in a like or similar manner.; In contrast with; as opposed to.; Not typical of one's character or personality.(n) Something that is not like something else; something different.(v) To dislike.; To withdraw support for a particular thing, especially on social networking websites.(n) The act of withdrawing one's like from a post on social media.
unlink: (v) To decouple; to remove a link from, or separate the links of.; To delete (a file).(n) A link that is equivalent (under ambient isotopy) to finitely many disjoint circles in the plane.
unlit: (aj) Not lit
unlive: (v) To bereave or deprive of life; make unalive.(v) To undo having lived (a period of time) (for example, by living it in reverse), so that it ceases to have happened.
unload: (v) To remove the load or cargo from (a vehicle, etc.).; To remove (the load or cargo) from a vehicle, etc.; To deposit one's load or cargo.; To give vent to or express; to unburden oneself of.; To remove (something previously loaded) from memory.; To discharge, pour, or expel.; To get rid of or dispose of.; To reduce the vertical load factor on an airplane's wing or other lifting surface, typically by pitching downwards toward the ground to decrease angle of attack and reduce the amount of lift generated.; To deliver forcefully.; To ejaculate, particularly within an orifice.; To draw the charge from.
unlock: (v) To undo or open a lock or something locked by, for example, turning a key, or selecting a combination.; To obtain access to something.; To configure (a mobile phone) so that it is not bound to any particular carrier.; To disclose or reveal previously unknown knowledge.; To be or become unfastened or unrestrained.(n) The act of unlocking something.
unmade: (aj) not (yet) made; existing without having been made; Without a hard, smooth, permanent surface.(v) simple past tense and past participle of unmake
unmake: (v) To destroy or take apart; to cause (a made article) to lose its nature.
unman: (v) To castrate; to remove the manhood of.; To sap (a person) of the strength, whether physical or emotional, required to deal with a situation.; To deprive of men.
unmask: (v) To remove a mask from someone.; To expose, or reveal the true character of someone.; To remove one's mask.; To cease engaging in masking, to cease disguising one's autism.; To enable (an interrupt, etc.) by unsetting or setting the associated bit.
unmeet: (aj) Not meet or proper.
unmoor: (v) To unfix or unsecure (a moored boat).; To set free or loose.; To weigh anchor.
unpack: (v) To remove from a package or container, particularly with respect to items that had previously been arranged closely and securely in a pack.; To empty containers that had been packed.; To analyze a concept or a text; to explain.; To undergo separation of its features into distinct segments.; To unzip, decompress.
unpaid: (aj) Not paid for.; Of work: done without agreed payment, usually voluntarily.
unpeg: (v) To remove from a peg.
unpen: (v) To release from a pen.
unpile: (v) To remove from a pile or stack.
unpin: (v) To unfasten by removing a pin.; To detach (an icon, application, etc.) from the place where it was previously pinned.; to get out of a pin
unplug: (v) To disconnect from a supply, especially an electrical socket.; To stop using electronic devices, especially for relaxation or to reduce stress.; To remove a blockage from (especially a water pipe or drain).; To temporarily disconnect from worldly experiences.
unread: (aj) Not having been read.; Not having read; uneducated.(v) To undo the process of reading.; To flag (a previously read e-mail or similar message) as not having been read.
unreal: (aj) Not real or substantial; having no actual presence in reality; lacking the characteristics of reality.; very impressive; amazing; unbelievable; incredible; larger or more fantastic than typical of real life.
unreel: (v) To remove or uncoil from a reel.
unrest: (n) A state of trouble, confusion and turbulence, especially in a political context; a time of riots, demonstrations and protests.
unrig: (v) To remove the rigging from (a vessel, etc.).; To disable.; To undress (someone).
unripe: (aj) Not ripe.; Developing too early; premature.
unrobe: (v) To disrobe, to undress.
unroll: (v) To straighten something that has been rolled, twisted or curled.; To emerge, be revealed or become apparent; to unfold.; To replace (a loop in a program) with a repetitive sequence of the individual instructions that the loop would carry out, sometimes used as an optimization.
unroof: (v) To remove a roof from, e.g. a building.
unroot: (v) To tear up by the roots; to uproot.
unruly: (aj) Wild; uncontrolled.
uns: (n) plural of un
unsafe: (aj) Not safe (various senses); dangerous.(v) To remove the safety from (a weapon).
unsaid: (v) simple past tense and past participle of unsay(aj) Unspoken.
unsay: (v) To withdraw, retract (something said).; To not have said (since this is physically impossible, usually in the subjunctive).
unseal: (v) To break the seal of (something) in order to open it.; To open by having a seal broken.
unseam: (v) To open the seam or seams of; to rip; to cut open.
unseat: (v) To throw from one's seat; to deprive of a seat.; To deprive of the right to sit in a legislative body, as for fraud in election, or simply by defeating them in an election.
unseen: (aj) Not seen or discovered; invisible.; Unskilled; inexperienced.; Not hitherto noticed; unobserved.(v) past participle of unsee(n) An examination involving material not previously seen or studied.
unset: (aj) Not set; not fixed or appointed.; Not mounted or placed in a setting.; Not set (broken bone); Not planted.; uncongealed, unconsolidated (concrete, cement)(v) To make not set.
unsex: (v) To deprive of sexual attributes or characteristics.; To sterilize (deprive of the ability to procreate); to castrate.
unshed: (aj) That has not been shed.
unship: (v) To unload cargo from a ship or other vessel; To remove an oar or mast from its normal position; To throw from a horse; to unseat
unshod: (aj) Not shod; without shoes.; Of a vehicle, not fitted with tyres on the wheels.(v) simple past tense and past participle of unshoe
unsnap: (v) To unfasten (something held by snaps).
unsold: (aj) Not sold
unstep: (v) To remove (the mast) from a sailing vessel.
unstop: (v) To remove a stoppage; to clear a blockage.; To unplug or uncork a container.; To draw out the stops of (an organ).
unsung: (aj) Which has not been lauded or appreciated.; Not sung.
unsure: (aj) uncertain; unstable or precarious
untidy: (aj) Sloppy.; Disorganized.(v) To make untidy, to make a mess
untie: (v) To loosen, as something interlaced or knotted; to disengage the parts of.; To free from fastening or from restraint; to let loose; to unbind.; To resolve; to unfold; to clear.; To become untied or loosed.; In the Perl programming language, to undo the process of tying, so that a variable uses default instead of custom functionality.
untied: (aj) Not tied; undone(v) simple past tense and past participle of untie
until: (p) Up to the time of (something happening).; Up to (a certain place); Before (a time).; To; physically towards.(c) Up to the time that (a condition becomes true).; Before (a condition becoming true).
unto: (c) Up to the time or degree that; until.(p) Up to, indicating a motion towards a thing and then stopping at it.; To, indicating an indirect object.
untold: (aj) Not told; not related; not revealed; secret.; Not numbered or counted.; Not able to be counted, measured, told, expressed in words, or described; extremely large in scale, number, quantity, suffering, damage, etc.; uncountable, unmeasurable, immeasurable, indescribable, inexpressible.
untrue: (aj) False; not true.; Not faithful or loyal.
untuck: (v) To remove something from a relatively hidden location or position where it is tucked.; To remove that which is concealing one’s penis and testicles such as gaff or adhesive tape.
untune: (v) To cause (something) to be out of tune; to make incapable of harmony, or of harmonious action.
unused: (aj) Not used.; Not accustomed (to), unfamiliar with.
unveil: (v) To remove a veil from; to uncover; to reveal something hidden.; to show, especially for the first time; To remove a veil; to reveal oneself.
unwary: (aj) Lacking caution as a result of naïveté or inexperience; Unprepared; not watchful
unwell: (aj) Not in good health; not feeling well; somewhat ill; Specifically, ill from menstruation; affected with, or having, catamenial; menstruant.
unwept: (aj) Not wept.; Unmourned.
unwind: (v) To separate (something that is wound up); To disentangle; To relax; to chill out; to rest and relieve of stress; To be or become unwound; to be capable of being unwound or untwisted.; To close out a position, especially a complicated position.; To undo something.; To analyse (a call stack) so as to generate a stack trace etc.(n) Any mechanism or operation that unwinds something.
unwise: (aj) Not wise; lacking wisdom
unwish: (v) To wish not to be; to destroy by wishing.; To undo a wish
unwrap: (v) To open or undo, as what is wrapped or folded.; To become unwrapped.; To remove word wrap from.
unyoke: (v) To release something from a yoke or harness.; To disconnect, unlink.; To liberate, deliver from oppression.; To unyoke an animal.; To cease from labour.
unzip: (v) To open something using a zipper.; To come open by means of a zipper.; To restore (compressed data) to its original form, from a zip file.
up: (av) Away from the surface of the Earth or other planet; in opposite direction to the downward pull of gravity.; To or at a physically higher or more elevated position.; To a higher level of some quantity or notional quantity, such as price, volume, pitch, happiness, etc.; To or in a position of equal advance or equality; not short of, back of, less advanced than, away from, etc.; usually followed by to or with.; Used as an aspect marker to indicate a completed action or state; thoroughly, completely.; To or from one's possession or consideration.; North.; Towards or at a central place, or any place that is visualised as 'up' by virtue of local features or local convention, or arbitrarily, irrespective of direction or elevation change.; Towards the principal terminus, towards milepost zero.; Aside, so as not to be in use.; Against the wind or current.; In a positive vertical direction.; Relatively close to the batsman.; Without additional ice.; To university, especially to Cambridge or Oxford.(p) Toward the top of.; Toward the center, source, or main point of reference; toward the end at which something is attached.; From south to north of.; Further along (in any direction).; From the mouth towards the source of (a river or waterway).; Of a man: having sex with.; At (a given place, especially one imagined to be higher or more distant from a central location).(aj) Facing upwards.; On or at a physically higher level.; Headed or designated to go upward (as an escalator, stairway, elevator etc.) or toward (as a run-up).; Fitted or fixed at a high or relatively high position, especially on a wall or ceiling.; Available to view or use; made public; posted.; Aloft.; Raised; lifted.; Built, constructed.; Standing; upright.; Risen up, rebelling, in revolt.; Awake and out of bed.; Riding the horse; mounted.; Above the horizon, in the sky.; Larger; greater in quantity, volume, value etc.; Indicating a larger or higher quantity.; Ahead; leading; winning.; Finished, to an end; In a good mood.; Willing; ready.; Next in a sequence.; Happening; new; of concern. See also what's up, what's up with.; Said of the higher-ranking pair in a two pair.; Well-informed; current.; Functional; working.; Traveling towards a major terminus.; Chilled and served without ice.; Erect.; well-known; renowned(n) The direction opposed to the pull of gravity.; A positive thing, or a time or situation when things are going well.; An up quark.; An upstairs room of a two story house.(v) To physically raise or lift.; To increase the level or amount of.; To promote.; To rise to a standing position; hence, by extension, to act suddenly; see also up and.; To ascend; to climb up.; To upload.
upas: (n) A tree, Antiaris toxicaria, of the mulberry family, common in the forests of Java and the neighboring islands, with poisonous secretions.; A virulent poison used in Java and the adjacent islands for poisoning arrows derived from the tree.; A poison prepared from the climbing plant Strychnos tieute.
upbear: (v) To hold up; raise aloft; hold or sustain high
upbeat: (aj) Having a fast pace, tempo, or beat.; Having a positive, lively, or perky tone, attitude, etc.(n) An unaccented beat at the start of a musical phrase.
upcast: (aj) Cast up; thrown upward.(n) A cast; a throw.; The ventilating shaft of a mine out of which the air passes after having circulated through the mine.; A current of air passed along such a shaft.; An upset, as from a carriage.; A taunt; a reproach.; A cast from subtype to supertype.; A message transmitted via upcasting.(v) To cast or throw up; to turn upward.; To taunt; to reproach; to upbraid.; To cast from subtype to supertype.; To broadcast a message or data to aircraft or satellites, especially via radio waves; as opposed to uplinking to a specific satellite or aircraft
update: (n) An advisement providing more up-to-date information than currently known.; A change in information, a modification of existing or known data.; An additional piece of information. An addition to existing information.; A modification of something to a more recent, up-to-date version; (in software) a minor upgrade.; A version of something which is newer than other versions.(v) To bring (a thing) up to date.; To bring (a person) up to date: to inform (a person) about recent developments.
updo: (n) A woman's hairdo in which most hair is kept above the neck
upend: (v) To end up; to set on end.; To tip or turn over.; To destroy, invalidate, overthrow, or defeat.; To affect or upset drastically.
upheld: (v) simple past tense and past participle of uphold
uphild: (v) plural of uphold
uphill: (av) Up a slope, towards higher ground.; With difficulty.(aj) Located up a slope or on a hill.; Going up a slope or a hill.; Difficult or laborious.(n) An uphill route.
Uphill: (N) A suburban village in Weston-super-Mare parish, North Somerset, Somerset, England (OS grid ref ST3158).; A community in Dalton Township, Ontario, Canada.; A surname.
uphold: (v) To hold up; to lift on high; to elevate.; To keep erect; to support; to sustain; to keep from falling; To support by approval or encouragement, to confirm (something which has been questioned)
Uphold: (N) A surname.
uphroe: (n) Alternative form of euphroe
upkeep: (n) Maintenance; the act or effort of keeping something in good and working condition.(v) To maintain (something) or keep it in good repair.
upland: (n) The area in the interior of a country with a generally higher elevation; often hilly, but not generally mountainous (compare highlands).; The country, as against the town.(aj) Of, relating to, or situated in the uplands.
Upland: (N) A city in San Bernardino County, California, United States.
uplift: (v) To raise something or someone to a higher physical, social, moral, intellectual, spiritual or emotional level.; To aggravate; to increase.; To be accepted for carriage on a flight.; To remove (a child) from a damaging home environment by a social welfare organization.; To remove (a document) from its current possessor and take it into one's own possession.(n) The act or result of being uplifted.; A tectonic upheaval, especially one that takes place in the process of mountain building.; The picking up and loading of goods to be transported by a mover.; A brassiere that raises the breasts.; An increase in a fine or penalty due to aggravating circumstances.
upmost: (aj) Uppermost.(aj) Misspelling of utmost.
upon: (p) Physically above and in contact with.; Physically directly supported by.; Being followed by another so as to form a series.; At (a prescribed point in time).; On.(av) Being the target of an action.
upper: (aj) At a higher level, rank or position.; Situated on higher ground, further inland, or more northerly.; younger, more recent; Of or pertaining to a secondary school.(n) A stimulant, such as amphetamine, that increases energy and decreases appetite.; The upper portion of something; The piece of leather, etc., that forms the top part of a shoe above the sole.; The upper portion of something; The Y-shaped strap on flip-flops.; Someone with higher social standing; A senior student.; That which is higher, contrasted with the lower.; A tooth in the upper jaw.; That which is higher, contrasted with the lower.; A denture or retainer for the teeth in the upper jaw.; That which is higher, contrasted with the lower.; An upper berth or bunk.; A spiritual passageway through which consciousness can reach a higher dimension.
upping: (v) present participle of up(n) The act of increasing something.
uppish: (aj) Having plenty of money.; proud; arrogant; assuming; In which the ball is hit into the air, with the chance of being caught.
uppity: (aj) Presumptuous, above oneself, self-important; arrogant, snobbish, haughty.; Exceeding one's station or position, assuming prerogatives to which one is not entitled.
uprear: (v) To raise something up; to rise up; to erect
uprise: (v) To rise; to get up.; To have an upward direction or inclination.; To rebel or revolt; to take part in an uprising.(n) The act of rising; appearance above the horizon; rising.
uproar: (n) Tumultuous, noisy excitement.; Loud, confused noise, especially when coming from several sources.; A loud protest, controversy, or outrage.(v) To throw into uproar or confusion.; To make an uproar.
uproot: (v) To tear up (a plant, etc.) by the roots, or as if by the roots; to extirpate, to root up.; To destroy (something) utterly; to eradicate, exterminate.; To remove (someone or something) from a familiar circumstance, especially suddenly and unwillingly.; Of oneself or someone: to move away from a familiar environment (for example, to live elsewhere).(n) The act of uprooting something.(v) Of a pig or other animal: to dig up (something in the ground) using the snout; to rummage for (something) in the ground; to grub up, to root, to rout.
uprose: (v) simple past tense and past participle of uprise
uprush: (n) An upwards rush.(v) To rush upward.
ups: (n) plural of up(v) Third-person singular simple present indicative form of up(i) Misspelling of oops.
UPS: (v) To connect a device to an uninterruptible power supply
upset: (aj) Angry, distressed, or unhappy.; Feeling unwell, nauseated, or ready to vomit.(n) Disturbance or disruption.; An unexpected victory of a competitor or candidate that was not favored to win.; An overturn.; An upset stomach.; An upper set; a subset (X,≤) of a partially ordered set with the property that, if x is in U and x≤y, then y is in U.; The dangerous situation where the flight attitude or airspeed of an aircraft is outside the designed bounds of operation, possibly resulting in loss of control.(v) To make (a person) angry, distressed, or unhappy.; To disturb, disrupt or adversely alter (something).; To tip or overturn (something).; To defeat unexpectedly.; To be upset or knocked over.; To set up; to put upright.; To thicken and shorten, as a heated piece of iron, by hammering on the end.; To shorten (a tire) in the process of resetting, originally by cutting it and hammering on the ends.
upsets: (n) plural of upset(v) Third-person singular simple present indicative form of upset
upshot: (n) The final result, or outcome of something.; A concise summary.
upside: (n) The highest or uppermost side or portion of something.; A favourable aspect of something that also has an unfavourable aspect.; An upward tendency, especially in a financial market etc.(p) On the top of.
uptake: (n) Understanding; comprehension.; Absorption, especially of food or nutrient by an organism.; The act of lifting or taking up.; A chimney.; The upcast pipe from the smokebox of a steam boiler towards the chimney.(v) To take up, to lift.; To absorb, as food or a drug by an organism.; To accept and begin to use, as a new practice.
uptown: (n) the residential part of a city, away from the commercial center(aj) In the upper part of a town.; Of or relating to an affluent area or population.(av) To or in the upper part of a town.
upturn: (n) an upward turn or trend, especially in business activity or profit(v) to turn (something) up or over
upward: (av) In a direction from lower to higher; toward a higher place; in a course toward the source or origin; In the upper parts; above.; Yet more; indefinitely more; above; over.(n) The upper part; the top.(aj) Directed toward a higher place.
Upward: (N) A surname.
upwind: (aj) exposed to the wind(av) in the direction from which the wind is blowing(v) To wind upwards.; To wind up (a mechanism).
ur: (i) Expressing hesitation or inarticulacy; er, um.
Ur: (N) An ancient Sumerian city in Mesopotamia, in modern Iraq; modern Tell el-Muqayyar.(N) A hypothetical early supercontinent which may have existed on Earth during the Archaean eon.
uracil: (n) One of the bases of RNA, pairing with adenine.
uraeus: (n) A representation of the sacred asp, symbolising supreme power in ancient Egypt.
Uralic: (aj) Pertaining to the Finno-Ugric and Samoyedic peoples, whose urheimat was the Ural Mountains, or to their languages, which constitute a language family, the Uralic languages.
urania: (n) Any of several impure mixtures of uranium oxides.
Urania: (N) The Muse of astronomy.; 30 Urania, a main belt asteroid.
uranic: (aj) Containing uranium in higher valences than uranous compounds.; Heavenly, celestial; astronomical.
Uranus: (N) The seventh planet in our solar system, with twenty-seven known moons, discovered in 1781 by Sir William Herschel.; The Greek god who personified the sky and heavens and fathered the Titans. Roman counterpart: Caelus.
uranyl: (n) The divalent radical UO₂²⁺, conveniently regarded as a residue of many uranium compounds.
urban: (aj) Related to the (or any) city.; Characteristic of city life.; Relating to contemporary African American culture, especially in music.; (of inhabitants or residents) Black; African American.
Urban: (N) A male given name from Latin; A patronymic surname, from given names.; An early Christian, also Urbane and Urbanus in various versions of the Bible. (biblical character)
urbane: (aj) Courteous, polite, refined, and suave, usually that of a man.
urchin: (n) A mischievous child.; A street urchin, a child who lives, or spends most of their time, in the streets.; A sea urchin.; One of a pair in a series of small card cylinders arranged around a carding drum; so called from its fancied resemblance to the hedgehog.; A neutron-generating device that triggered the nuclear detonation of the earliest plutonium atomic bombs.; A hedgehog.; A mischievous elf supposed sometimes to take the form of a hedgehog.
Urdu: (N) Modern Standard Urdu, an Indo-Aryan language with native speakers mainly in Pakistan and North India. It is a standardized and Persianized version of Hindustani. Also known natively to its speakers as Lashkari.(aj) Of or relating to the Urdu language.
ure: (n) use, practise, exercise.(v) To use; to exercise; to inure; to accustom by practice.(n) Synonym of aurochs
Ure: (N) A river in North Yorkshire, England, which flows through Wensleydale; A surname.
urea: (n) A water-soluble organic compound, CO(NH₂)₂, formed by the metabolism of proteins and excreted in the urine.; Any N-substituted derivative of urea, with the general formula (R₁R₂N)CO(NR₃R₄).
urease: (n) the enzyme, found in soil bacteria and some plants, that catalyzes the hydrolysis of urea into ammonia and carbon dioxide
uredines: (n) plural of uredo
uredo: (n) A summer stage in the life history of certain rusts (Uredinales), regarded at one time as a distinct genus, and preceding the teleutospore, or winter stage.; urticaria; nettle-rash
ureide: (n) Any compound, of general formula R-CO-NH-CO-NH₂ or R-CO-NH-CO-NH-CO-R', formally derived by the acylation of urea.
uremia: (n) Blood poisoning resulting from the retention of waste products usually excreted as urine.
ureter: (n) Either of the two long, narrow ducts that carry urine from the kidneys to the urinary bladder.
uretic: (aj) of, or relating to urine; urinary
urge: (n) A strong desire; an itch to do something.(v) To press; to push; to drive; to impel; to force onward.; To put mental pressure on; to ply with motives, arguments, persuasion, or importunity.; To provoke; to exasperate.; To press hard upon; to follow closely.; To present in an urgent manner; to insist upon.; To treat with forcible means; to take severe or violent measures with.; To press onward or forward.; To be pressing in argument; to insist; to persist.
urged: (v) simple past tense and past participle of urge
urgent: (aj) Requiring immediate attention.
urger: (n) One who urges.
Urger: (N) A surname.
urges: (n) plural of urge(v) Third-person singular simple present indicative form of urge
urging: (v) present participle of urge
Uriah: (N) Any of a number of Old Testament men, including the husband of Bathsheba whom David sent to death.; A male given name from Hebrew of Biblical origin.
urial: (n) A bearded reddish sheep, subspecies of Ovis orientalis (including Ovis orientalis vignei), previously classified as Ovis vignei, being endemic to southern Asia and believed to be a wild ancestor of domestic sheep.
uric: (aj) Pertaining to, contained in, or obtained from urine.
Uriel: (N) An archangel in Judaism and Christianity.; A male given name from Hebrew.
urinal: (n) A device or fixture used for urination; A glass vial used for examining or storing urine.; A device or fixture used for urination; A chamber pot specially designed or considered as a device for urination.; A device or fixture used for urination; A device for urination worn by patients suffering incontinence.; A device or fixture used for urination; A plumbing fixture intended for standing urination, typically by men and boys.; Any oblong glass vessel shaped like the old alchemist's urinal.; A room or structure used for urination: a latrine; an outhouse; a lavatory.(aj) Synonym of urinary
urine: (n) Liquid waste consisting of water, salts and urea, which is made in the kidneys, stored in the bladder, then released through the urethra.(v) To urinate.
urn: (n) A vase with a footed base.; A metal vessel for serving tea or coffee.; A vessel for the ashes or cremains of a deceased person.; Any place of burial; the grave.; A measure of capacity for liquids, containing about three gallons and a half, wine measure. It was half the amphora, and four times the congius.; A hollow body shaped like an urn, in which the spores of mosses are contained; a spore case; a theca.(v) To place in an urn.
urns: (n) plural of urn
uropod: (n) either of the two posterior abdominal appendages of the lobster, shrimp and some other crustaceans; the hind part of polarized leukocytes, mostly involved in cell-to-cell interaction, cell activation and apoptosis
ursine: (aj) Of, pertaining to, or characteristic of bears.; Of, pertaining to, or characteristic of the bear subfamily Ursinae.; Covered in stiff bristles.(n) A bear.
Ursine: (N) A census-designated place in Lincoln County, Nevada, United States.
Ursula: (N) A female given name from Latin.
urus: (n) The aurochs.
us: (P) Me and at least one other person; the objective case of we.; Me.; Our.; Me (in all contexts).(d) The speakers/writers, or the speaker/writer and at least one other person.(S) Alternative spelling of µs: microsecond(n) Alternative form of u's.
Us: (n) plural of U
usable: (aj) Capable of being used.; Easy to use; exhibiting good usability.; homosexual
usage: (n) Habit, practice.; A custom or established practice.; Habit, practice.; Custom, tradition.; Utilization.; The act of using something; use, employment.; Utilization.; The established custom of using language; the ways and contexts in which spoken and written words are used, especially by a certain group of people or in a certain region.; Utilization.; Action towards someone; treatment, especially in negative sense.
usages: (n) plural of usage
usance: (n) The length of time permitted for the payment of a bill of exchange.; Use.; Customary or habitual usage.; The interest paid on a borrowed sum, usury.
use: (n) The act of using.; The act of consuming alcohol or narcotics.; Usefulness, benefit.; A function; a purpose for which something may be employed.; Occasion or need to employ; necessity.; Interest for lent money; premium paid for the use of something; usury.; Continued or repeated practice; usage; habit.; Common occurrence; ordinary experience.; The special form of ritual adopted for use in any diocese.; A slab of iron welded to the side of a forging, such as a shaft, near the end, and afterward drawn down, by hammering, so as to lengthen the forging.(v) To utilize or employ.; To employ; to apply; to utilize.; To utilize or employ.; To expend; to consume by employing.; To utilize or employ.; To exploit.; To utilize or employ.; To consume (alcohol, drugs, etc), especially regularly.; To utilize or employ.; To consume a previously specified substance, especially a drug to which one is addicted.; To utilize or employ.; To benefit from; to be able to employ or stand.; To accustom; to habituate. (Now common only in participial form. Uses the same pronunciation as the noun; see usage notes.); To become accustomed, to accustom oneself.; To suggest, request, demand or expect that other people use a specific set of gender pronouns when referring to the subject.; To habitually do; to be wont to do. (Now chiefly in past-tense forms; see used to.); To behave toward; to act with regard to; to treat.; To behave, act, comport oneself.
used: (v) simple past tense and past participle of use; to perform habitually; to be accustomed(aj) That is or has or have been used.; That has or have previously been owned by someone else.; Familiar through use; usual; accustomed.
useful: (aj) Having a practical or beneficial use.
usefuls: (n) plural of useful
user: (n) One who uses or makes use of something, a consumer/client or an express or implied licensee (free user) or a trespasser.; A person who uses drugs, especially illegal drugs.; A person who uses a computer or a computing network, especially a person who has received a user account.; An exploiter, an abuser (a person who "uses" people, that is treats and regards people unfairly, selfishly and/or unethically).; In land law, meaning either 1. or 2. above or use. Usually in singular form to mean use wherever there is assiduous re-use of precedents and aloof textbooks verbatim.
users: (n) plural of user
uses: (n) plural of use(n) A form of equitable ownership peculiar to English law, by which one person enjoys the profits of lands, etc. whose legal title is vested in another in trust.(v) Third-person singular simple present indicative form of use
Ushant: (N) An island located in Finistère department, Brittany, France, at the southwestern end of the English Channel, marking the northwesternmost point of metropolitan France.
usher: (n) A person, in a church, cinema etc., who escorts people to their seats.; A male escort at a wedding.; A doorkeeper in a courtroom.; An assistant to a head teacher or schoolteacher; an assistant teacher.; Any schoolteacher.(v) To guide people to their seats.; To accompany or escort (someone).; To precede; to act as a forerunner or herald.; to lead or guide somewhere
Usher: (N) An occupational surname, from occupations for an usher.
ushers: (n) plural of usher
Ushers: (N) plural of Usher
using: (v) present participle of use(n) use; utilization
Usk: (N) A river in Powys and Monmouthshire, Wales, that empties into the Severn at Newport.; A town in Monmouthshire, Wales, on this river.
usual: (aj) Most commonly occurring; typical.(n) The typical state of something, or something that is typical.; A specific good or service (e.g. a drink) that someone typically orders.
usurer: (n) A person who loans money to others and charges interest, particularly at an illegal, exorbitant, or unfair rate.
usurp: (v) To seize power from another, usually by illegitimate means.; To use and assume the coat of arms of another person.; To take the place rightfully belonging to someone or something else.; To make use of.
usurps: (v) Third-person singular simple present indicative form of usurp
usury: (n) An exorbitant rate of interest, in excess of any legal rates or at least immorally.; The practice of lending money at such rates.; The practice of lending money at interest.; Profit.
ut: (n) Syllable (formerly) used in solfège to represent the first note of a major scale.
Utah: (N) A state in the western United States. Capital and largest city: Salt Lake City.; An unincorporated community in Warren County, Illinois.; An unincorporated community in Dearborn County, Indiana.; A remote rural locality and civil parish in northwestern New South Wales, Australia; University of Utah.
ute: (n) A small vehicle based on the same platform as a family car but with a unibody construction and a built-in open tray area for carrying goods; similar but not identical to a pick-up truck.
Ute: (N) A Native American people of Utah, Colorado and New Mexico.; The language of this people, of the Numic branch of the Uto-Aztecan language family.(n) A member of this people.
uterus: (n) The womb, an organ of the female reproductive system in which the young are conceived and develop until birth.
Utica: (N) A Phoenician colony on the African coast, near Carthage.; A city, the county seat of Oneida County, New York; named for the Phoenician colony.; A city in Michigan; named for the city in New York.; A village in Ohio; named for the city in New York.; North Utica (a village in Illinois, often called "Utica"); A census-designated place in South Carolina.; A town in Winnebago County, Wisconsin.; A village in Nebraska; named for the city in New York.; A town in Mississippi; named for the city in New York.; A town in Indiana.; A town in Crawford County, Wisconsin.; A city in Minnesota; named for the city in New York.; A village in Missouri; named for the city in New York.; A borough of Pennsylvania.; A city in Kansas; named for the city in New York.; A town in South Dakota.; A census-designated place in Kentucky; named for the city in New York.; An unincorporated community in Maryland.; An unincorporated community in Montana.; An unincorporated community in Oklahoma.; An unincorporated community in West Virginia.; An unincorporated community in Dane County, Wisconsin.; A ghost town in Texas.
utile: (aj) Useful.(n) A theoretical unit of measure of utility, for indicating a supposed quantity of satisfaction derived from an economic transaction.
utmost: (aj) Situated at the most distant limit; farthest, outermost.; The most extreme; greatest, ultimate.(n) The greatest possible capability, extent, or quantity; maximum.
utopia: (n) A world in which everything and everyone works in perfect harmony.
utter: (aj) Outer; furthest out, most remote.; Outward.; Absolute, unconditional, total, complete.(v) To produce (speech or other sounds) with one's voice.; To reveal or express (an idea, thought, desire, etc.) with speech.; To produce (a noise) (of an inanimate object).; To spit or blow (something) out of one's mouth.; To emit or give off (breath).; To shed (a tear or tears).; To offer (something) for sale; to sell.; To put (currency) into circulation.; To show (something that has been hidden); to reveal the identity of (someone).; To send or put (something) out.
Utter: (N) A surname.
utters: (v) Third-person singular simple present indicative form of utter
Utters: (N) plural of Utter
utu: (n) Recompense, payback; revenge.
Utu: (N) A Sumerian deity, the son of the moon god Nanna and the goddess Ningal.
utus: (n) plural of utu
uvea: (n) The middle of the three concentric layers that make up the eye; it is pigmented and vascular, and comprises the choroid, the ciliary body, and the iris.
uvula: (n) Ellipsis of palatine uvula: the fleshy appendage that hangs from the back of the soft palate, that closes the nasopharynx during swallowing; the slight elevation in the mucous membrane immediately behind the internal urethral orifice of the urinary bladder, caused by the middle lobe of the prostate; an object so suspended inside a bell that it may hit the bell and cause it to ring; a clapper
uvular: (aj) Of or relating to the uvula.; Of a sound, articulated with the uvula.(n) A sound articulated with the uvula.
Uzbek: (n) A person from Uzbekistan or of Uzbek descent.(aj) Of, from, or pertaining to Uzbekistan, the Uzbek people or the Uzbek language.(N) The language of Uzbekistan.
